A-(1)	"ئەی"
A-Programming-Language-	زمانی پرۆگرامکردنی "ئەی"،
A+	ئەی‌پڵەس
a-bus	تێپەڕگەی "ئەی"
a-ring-(=-a-circle)	"ئەی‌‌‌‌ڕینگ"، ئەی‌بازنه، ئای ئاڵقەدار، ئای بازنەدار‌
a2b	ئەی‌توو‌بی
A4	ئا٤، ئاچوار
A5	ئا٥، ئاپێنج
A:	ئا جووتخاڵ
AAA	تریپڵ ئەی، ڕەسەنێتی، دەسەڵاتپێدان و ژمێریاری
AAAI	تریپڵ‌ئەی‌‌ئای، کۆمەڵەی ئەمریکی بۆ هزری دەستکرد
AAC	ئە‌ی‌ئەی‌سی
AB-roll	خلۆریی ئەی‌بی
abacus	چۆرت، ئەژمێر
abandon	وازلێهێنان. وەلانان
abandon-text	وازلێهێنانی دەق
abandonware	فڕێواڵە، بەرنامەواڵەی وازلێهێنراو
abbreviate	کورتەکردنەوە، کورتکردنەوە
abbreviated	کورتە
abbreviated-addressing-	ناونیشانپێدانی کورتە
abbreviation-	١ـ کورتکردنەوە ٢ـ کورتە، کورتکراوه
abbreviations	١ـ فەرماننامەی کورتەکان ٢ـ کورتەکان
abbreviation[s]-file	پەڕگەی کورتەکان
ABC	١ـ ئەلفبێ٢ـ بنەماکان ٣ـ پەڕتووکی سەرەتایی ٤ـ ئەلفبێی کار، سەرەتاکانی کار ٥ـ ئەی‌بی‌سی (کۆمپیوتەری ئاتانازۆف‌ـ بێڕی، لە مێژووی کۆمپیوتەردا)
abend-(=-abnormal-end-=-abnormal-termination)	١ـ "ئابێند"، دواییهاتنی نائاسایی، کۆتاییپێهاتنی نائاسایی  ٢ـ کۆتاییپێهێنانی نائاسایی
abend-recovery-program	بەرنامەی چێکەرەوەی "ئابێند"
ability	توانا، لێهاتوویی
ABIOS	ئەی‌بایووز، ئەی‌بی‌ئای‌ئۆ‌ئێس
abnormal	ناوازە، نائاسایی، ناسروشتی
abnormally	نائاسایییانە، ناسروشتییانه
abort	١ـ پچڕاندن، کوژاندنەوە ٢ـ لابردن، وەستاندن، كۆتاییپێهێنان (کۆتاییپێهێنانی بەئەنقەستی جێبەجێکردنی بەرنامە لەبەر سەرهەڵدانی هەڵە) ٣ـ کۆتاییپێهاتن (کۆتاییپێهاتنی جێبەجێکردنی بەرنامە لەلایەن سیستەمی کارپێکردنەوە)
about...-	سەبارەت...
abridge	کورتکردنەوە
abridged	کورتەیی (ئاوەڵناو)
abridged-version	وەشانی کورتەیی (لە پەڕتووک و دراوەدا‌)
abridgement	کورتکاری، پوختەکاری
abrupt	لەپڕ، لەناکاو، کوتوپڕ
abscissa	ڕایەڵی ئاسۆیی، پۆ
absolute	١ـ ڕەها، بێپایان، بێجڵەو، بێسنوور، بەربەرەڵا ٢ـ تەواو
absolute-address-(actual-address-=-machine-address-=-direct-address)	ناونیشانی ڕەها، ناونیشانی پەتی، ناونیشانی ڕاستەقینە، ناونیشانی ماشینی، ناونیشانی فیزیکی
absolute-addressing	ناونیشانپێدانی ڕەها
absolute-assembler	ئەسمبلەری ڕەها
absolute-code-(1)-(=-absolute-program)	بەرنامەی ڕەها، بەرنامەی ماشینی
absolute-code-(2)	کۆدی ڕەها، نهێنیی ڕەها، نهێنیی کردەی ڕەها
absolute-disk-address	ناونیشانی ڕەهای دیسک، ناونیشانی فیزیکیی دیسک
absolute-error	هەڵەی ڕەها، هەڵەی پەتی
absolute-instruction-(=-actual-instruction)	ڕێکارنامەی ڕەها، ڕێکارنامەی پەتی
absolute-loader	بارکەری پەتی
abstract-(1)	پوخته، کورته
abstract-(2)	١ـ ڕووت، نەبینراو، نادیار‌، لێدابڕاو ٢ـ پوختەکردن، کورتکردنەوە ٣ـ ڕووتکردن، بەڕووتی
abstract-data-type	جۆرەـ‌ دراوەی ڕووت
abstract-specification	تایبەتمەندیی ڕووت
abstractor	پوختەنووس، پوختەساز
accelerate	١ـ تاودان، لەزپێدان، خێراکردن، گوڕپێدان ٢ـ تاوسەندن، لەزگرتن، گوڕگرتن
accelerated	تاودراو، تاوگرتوو، لەزگرتوو، تاودار
acceleration	تاو، لەز، گوڕ، خێرایی
acceleration-function	پابەندی تاو
accelerator	تاودەر
acceptance	وەرگرتن، وەرگیران
acceptance-number-(=-ACCN)	ژمارەی وەرگیران
acceptance-test	ئەزموونی وەرگیران، تاقیکردنەوەی وەرگیران
acceptor	وەرگر
access	١ـ چوونەناو، دەستپێگەیشتن، ڕێی چوونەژوورەوە یاتێپەڕبوون ٢ـ مافی چوونەناو یان چوونەژوورەوە
access-arm	باسکی دەستپێگەیشتن، قۆڵی دەستپێگەیشتن
access-barred	دەستپێگەیشتنی نەلواو، دەستپێگەیشتنی ڕێپێنەدراو
access-charge	مزی دەستپێگەیشتن
access-code-(=-password)	تێپەڕوشه، تێپەڕەوشە
accessibility	توانای دەستپێگەیشتن، دەستپێگەیشتەنێتی، توانای چوونەژوورێتی
account-(=-user-account)	هەژمار، هەژماری بەکارهێنەر
accountancy	ژمێریاری
accumulator-	كۆكەر
acoustic-(=-acoustical)	١ـ دەنگی ٢ـ دەنگناسی، دەنگزانی فەرماننامەی بێناونیشان، ڕێکارنامەی بێناونیشان
acquire	بەدەستهێنان (ی مافی لەچاپدانەوە)، کڕینی ماف (ی لەچاپدانەوە)
acquiring-editor	پێداچووی مافی لەچاپدانەوە
Acrobat	ئەكروبات
acronym	سەروشە
action	کردار، کار، کردە، کردەوە
active	چالاك، كارا
ActiveX	ئەکتیڤ‌ئێکس (‌ActiveX)
AD-[After-Dark-image]	(جۆرە درێژکراوەیەکی پەڕگە)
Ada-(=-ADA)	ئادا، ئێیدا
Ada-language	زمانی ئادا، زمانی ئێیدا
Ada-programming	بەرنامەکردنی‌ ئادا، بەرنامەکردن بە زمانی ئێیدا
adapt	سازکردن، گونجاندن
adapter	سازكەر، گونجێنەر
add	خستنەسەر، کۆکردنەوه، پێوەنان
add-on	١ـ پێوەکراو، زیاترکراو، سەرخراو، زێدەکراو ٢ـ زیاترکەر، پێزیادکەر، وەسەرخەر
address	ناونیشان
address-bar	تووڵی ناونیشان
address-bus	تێپەڕگەی ناونیشان
addressless-instruction-(=-zero-addressed-instruction)	فەرماننامەی بێناونیشان، ڕێکارنامەی بێناونیشان
adminstration	بەڕێوەبەری، بەڕێوەبەرایەتی، فەرمانگە
adminstrator	بەڕێوەبەر
advanced	پەرەسەندوو
adware	بانگەشەواڵە، پرۆگرامی بانگەشه
alias	ناسراو بە، نازناو، ناوی خوازیار، خوازناو
aliasing	١ـ خاوڕۆیی ٢ـ زیگزاگ، لابەلا
align	هاوڕێکی، هاوهێڵی، هاوتەختی، لاڕێككردن، لاگرتن
alignment	لاگرتن، ڕیزكردن.
alpha	ئالفا
alphanumeric	ئەلفژمارەیی
alternate	لەبری، جێگرەوە، بژارە
analog-(1)-	لێکچوو، هاویەک، هاوتا، هاوشێوە، بەرانبەر
analog-(2)-	بەراوردی، پێوانەیی، بەراوردکارانە (ناڕەنووسی)
analog-(3)-	بەراوردی، ئامێری بەراوردی، ئامێری پێوانەیی، ئامێری بەراوردکارانە (لە بەرانبەر "ئامێری ڕەنووسی")
analog-adder	پێزیادکەری پێوانەیی
analysis	شیكردنەوه، شیتەڵکاری
anchor	لەنگەر
animation	جووڵاو، بزێو
annotation	یاداشت، پەراوێزنووسی
anonymous	نەناسراو، نەزانراو، بێناو، کەسنەناس
antiglare	دژەبریقە
antivirus	دژەڤایرۆس
Apache	ئەپاچی
APL-	ئەی‌پی‌ئێڵ
append	پاشكۆكردن، لەتەكخستن
Apple	"ئەپڵ"
Apple-Computer-(=-Apple-Macintosh-Computer-=-Macintosh-Computer)	کۆمپیوتەری ئەپڵ، پێژمێری ماکینتۆش
appliance	ئامێر، کەرەستە، دەزگا
appliance-computer	پێژمێری ئامادە، کۆمپیوتەری ئامادەی کار
applicabillity	بەکاربەریخوازی
applicable	بەکاربەریخواز
applicant	داواکار، داخواز
application-(1)	بەرنامەی بەکاربەری، نەرمەواڵەی بەکاربەری، بەرنامە، نەرمەواڵە
application-(2)	١ـ داوانامە، داخوازنامە ٢ـ پرۆگرام (ی پێژمێر) ٣ـ بەکاربەری، بەکارهێنان، کارپێکردن، خستنەکار ٤ـ کاری بەکاربەریی کۆمپیوتەر، کاری کردەنی، کارێ بکرێ ئەنجام ببێت
application-developer	بەرهەمهێنانی بەرنامەی بەکاربەری
application-development-language	زمانی بەرهەمهێنانی بەرنامەی بەکاربەری
application-development-system	سیستەمی بەرهەمهێنانی بەرنامەی بەکاربەری
application-file	پەڕگەی بەکاربەری
application-form	فۆرمی داوانامە، فۆرمی داخوازنامە
application-generator	دینەمۆی بەرنامە
application-icon	وێنۆچکەی بەکاربەری
application-package	گورزەی بەکاربەری، گورزەی نەرمەواڵەی بەکاربەری
application-program-	بنواڕه applications program
application-oriented-language	زمانی بەکاربەریخواز
applications-program	بەرنامەی بەکاربەری
applications-software	نەرمەواڵەی بەکاربەری
applications-terminal	کۆتاگەی بەکاربەری
applied	بەکاربەری، کردەنی، کردارەکی
applied-graphics	گرافیکی بەکاربەری، نیگارەسازیی بەکاربەری
apply	بەکاربردن
approach	نزیکبوونەوە، لێنزیکبوونەوە، چوون بەرەو
approval	١ـ پەسەندکردن، مۆرکردن، ڕەزامەندی ٢ـ  بەدڵبوون، پەسەندکردن ٣ـ ئافەرین
approve	١ـ پەسەندکردن، مۆرکردن ٢ـ بەلاوەباشبوون، ڕالەسەربوون
approximate	١ـ نزیک، لەیەکەوە نزیک ٢ـ وەک یەک، چونیەک ٣ـ نزیکەیی ٤ـ لێکچوون، لێککردن
approximation	١ـ لێکچوون، لێنزیکبوونەوە ٢ـ نزیکەیی
arbitrary	١ـ دڵویست، دڵخواز، بەمەیلی خۆ، لەڕووی ویستنەوە ٢ـ بێسەرووبەر، نابەجێ، لەخۆوە
arbitrary-constant	نەگۆڕی دڵویست، نەگۆڕی دڵخواز
architecture	تەلارسازی
archive	ئەرشیڤ
archived-(=-A)	ئەرشیڤی
area	١ـ ناوچە، هەرێم، شوێن ٢ـ ڕووبەر، ڕوو، پانتایی ٣ـ بەستێن، بوار
argue	١ـ بەڵگەهێنانەوە ٢ـ مشتومڕکردن، چەندوچۆنکردن
argument	١ـ بەڵگە ٢ـ مشتومڕ، دەمەقاڵێ
arithmetic	ژمێرەیی
array	ڕیز، ڕیزەك
arrow	تیر
ascending	هەڵچوون، بەرزبوون، بەرزەڕۆیی
ASCII	ئاسکی، ڕەمزی ئاسکی
ASCII-character	نووسەی ئاسکی
ASCII-character-set	کۆمەڵە نووسەی ئاسکی
ASCII-code	کۆدی ئاسکی
ASCII-file	پەڕگەی ئاسکی
ASCII-FTP-mode	دۆخە FTP ی ئاسکی
ASCII-keyboard	تەختەکلیلی ئاسکی
ASCII-string	ڕیزبەندی ئاسکی، ڕیزبەندی نووسەییی ئاسکی
ASCII-text	دەقی ئاسکی
ASP	لاپەڕە ڕاژەكارە کاراکان
assertion	١ـ سووربوون، داوا، خوازە، پێداگری ٢ـ دڵنیابوون
associate	هاوپەیوەند
at-(@)	ئالوول، ئاـ لوول
attachment	پاشكۆ
attempt	هەوڵدان
attribute	١ـ تایبەتمەندی، ئاكار، تایبەخۆ، پێناسە
audio	١ـ بیستەنی، بیستنی، ئاودیۆ ٢ـ دەنگ
Audio-frequency-(=-AF)	لە‌رەلەری بیستەنی
audit	پێداچوونەوە، لێپرسینەوە، پشكنین
authentication	ڕەسەنێتی
authorization-	ڕێپێدان، دەسەڵاتپێدان
authorized-user	بەكارهێنەری ڕێپێدراو، بەکارهێنەری دەسەڵاتپێدراو
auto-abstract	پوختەی کۆمپیوتەری
auto-scan	پشکنینی خۆکار
auto-	١ـ "خۆ"، "خۆکار" ٢ـ "کۆمپیوتەری"، "ماشینی" (پێشگر)
auto-answer	خۆوەڵام
auto-boot	خۆبووت، خۆوەکارخەر
auto-dialer-(=-auto-dial-=-autodial)	خۆژمارەگر
auto-repeat	خۆبارە، خۆپاتە
auto-stop	خۆوەست، خۆوەستان
autocode	١ـ خۆڕەمز ٢ـ بەرنامەی خۆکار ٣ـ بەرنامەی چێکردنی کۆمپیوتەری
autocorrect	ڕاستکردنەوەی خۆکار
autodial-(1)-(=-auto-dial)	١ـ ژمارەگری خۆکار ٢ـ ژمارەگرتنی خۆکار
autodial-(2)-(=-auto-dial)	خۆژمارەگر (لە مۆدێم و تەلەفۆندا)
autodial-modem	مۆدێمی خۆژمارەگر
AUTOEXEC.BAT	ئاوتۆـ‌ ئێگزێک ـ‌بەت
autofocus	ئاوتۆفوکوس، خۆمیقاتساز
autograph-(1)	واژۆ
autograph-(2)-(=-manuscript)	دەستنووس
Autograph-(3)-(=-dynamic-mathematics-software)	ئاوتۆگراف
autoidentifier	خۆناسکار
automate	١ـ خۆبەکاربەرین، بە خۆکارکردن ٢ـ کۆمپیوتەریکردن، ماشینیکردن
automatic	خۆكار، ئۆتۆماتیك
automation	خۆكاری
autoplay	خۆلێدان
autoresponder	خۆوەڵامدەر
autorestart	خۆدەستپێکردنەوە
autorun	خۆگەڕی
autosave-	خۆپاشەكەوت
AutoShapes	شێوەخۆكارییەكان
autotrack-	سۆراخكردنی خۆكار
avatar	"ئاڤاتار"
axis	تەوەرە، تەوەر
abandon	وازلێهێنان. وەلانان
abandon-text	وازلێهێنانی دەق
abandonware	فڕێواڵە، بەرنامەواڵەی وازلێهێنراو
abbreviate	کورتەکردنەوە، کورتکردنەوە
abbreviated	کورتە
abbreviated-addressing-	ناونیشانپێدانی کورتە
abbreviation-	١ـ کورتکردنەوە ٢ـ کورتە، کورتکراوه
abbreviations	١ـ فەرماننامەی کورتەکان ٢ـ کورتەکان
abbreviation[s]-file	پەڕگەی کورتەکان
ABC	١ـ ئەلفبێ٢ـ بنەماکان ٣ـ پەڕتووکی سەرەتایی ٤ـ ئەلفبێی کار، سەرەتاکانی کار ٥ـ ئەی‌بی‌سی (کۆمپیوتەری ئاتانازۆف‌ـ بێڕی، لە مێژووی کۆمپیوتەردا)
abend-(=-abnormal-end-=-abnormal-termination)	١ـ "ئابێند"، دواییهاتنی نائاسایی، کۆتاییپێهاتنی نائاسایی  ٢ـ کۆتاییپێهێنانی نائاسایی
abend-recovery-program	بەرنامەی چێکەرەوەی "ئابێند"
ability	توانا، لێهاتوویی
B-(1)	نیشانەی کورتەی "بایت"
B-(2)	"بی"
B:	ب‌جووتخاڵ، بێ‌-جووتخاڵ
back-(1)	١ـ پشت، پاش، دوا ٢ـ ڕابردوو (ئاوەڵناو) ٣ـ پاڵپشتیکردن
back-(2)	گەڕانەوە، بۆ دواوە، بۆ پاشەوە
backbone	گازەرا، بڕبڕە
backbone-network	ڕایەڵەی بڕبڕە
backdoor	پشتەدەرگا
backdrop-(=-background-plane)	پەردەی پاشبنەما
backfile-(=-backup-file)	پەڕگەی پاڵپشتی
background	پاشبنەما
backing	١ـ پاڵپشتی ٢ـ پشتیوانی
backslash-(\)	لارەهێڵی پێچەوانە
backspace-(key)	كلیلی دوابەر، كلیلی بەرەودوا
backup	پاڵپشت ـ پاراستن
bad-sector-	کەرتی خراپ، سەکتەری خراپ
badge-reader	نیشانەخوێن، نیشانەخوێنەر
balance	١ـ هاوسەنگی، هاوتایی ٢ـ تەرازوو ٣ـ هاوسەنگکردن، هاوتاکردن، هاوتەرازکردن
balanced	هاوسەنگ، هاوتا، هاوتەراز
balanced-bridge	پردی هاوسەنگ
balanced-error	هەڵەی هاوسەنگ
ball	گۆ
ball-printer	چاپکەری گۆدار
ban	ڕێگرتن
band	باند، نەوار، شریت
bandwidth	باندبەرینی
banner-(1)	بەیداخ، بەنێر
banner-(2)	سەردێڕی سەرەکی
banner-(3)	سەردێڕسازی
Banner-(4)	بەنێر
bar	تووڵ، شیش، میلە
barcode	تووڵكۆد
base	بنچینە
basic-(1)	بنچینەیی، بنچینە
BASIC-(2)-(=-Basic-=-Beginners-Symbolic-All-purpose-Instruction-Code)	بەیسیک
basic-code-(1)	بەرنامەی بنچینەیی
BASIC-code-(2)	بەرنامەی بەیسیک
BASIC-compiler	وەرگێڕی بەیسیک
basic-dictionary	وشەنامەی بنەما، وشەنامەی بنچینەیی
basic-shapes	شێوەبنەمایییەكان
batch	١ـ دەسته، پۆل، چەپک‌ ٢ـ دەستەیی، پۆلی، چەپکی ٣ـ دەستەکردن، دەستەییکردن، بەپۆلکردن، بەچەپککردن
batch-file-	پەڕگەی دەستەیی
benchmark-	هەڵسەنگێنەر
beta	بێتا
binary	دوویی، دوانی
BIOS	"بایۆز"، "بایوس"، "بی‌ئای‌‌ئۆ‌‌ئێس"
bit	بیت
blank	بەتاڵ، سپی
block	١ـ بەربەست ٢ـ بلۆک
blog	بلۆگ
blogger	بلۆگنووس
bluetooth	بلووتووس، ددانشین
bookmark-(1)	پەڕتووکنیشانەکەر، جێنیشانەکەر، جێدۆز
bookmark-(2)	پەڕتووکنیشانەکەر، نیشانەکەری نێوان کتێب، نیشانەکەری شوێن یان وێبگە، شوێندۆزی وێبگه، وێبگەنیشانەکەر‌
boolean-(1)-(=-logical-=-Boolean)	بوولی
Boolean-(2)-(=-Boolean)	كەمایەتیی بوولی، گۆڕاوی بوولی
boolean-algebra	جەبری بوولی
boot	"بووت"، خستنەڕێ
bounce-(1)	دەركردن
bounce-(2)	گەڕانەوە
box	باوڵ، سندووق، جێدان
BRB	"هەر ئێستە دێمەوه"‌
broadband	بەرینباند
broadcast	بڵاوكردنەوه، پەخش، وەشان
browser	گەڕۆك، ئینتەرنێتخوێنەر
budget	بوودجه
buffer	نێوانگر، بیرگەی نێوانگر
bug	كەلێن، چەوتی، هەڵە
build	١ـ پێکهێنان ٢ـ بەرزکردنەوە
burner	سووتێنەر
burst	١ـ تەقینەوە ٢ـ تەقاندنەوە
bus	تێپەڕگە
busy	سەرقاڵ
busy-hour	کاژێری سەرقاڵی
button	دوگمە
bypass	لاتێپەڕی، بەلاداتێپەڕین
byte-	بایت، هەشتە، هەشت بیت
bad-sector-	کەرتی خراپ، سەکتەری خراپ
badge-reader	نیشانەخوێن، نیشانەخوێنەر
balance	١ـ هاوسەنگی، هاوتایی ٢ـ تەرازوو ٣ـ هاوسەنگکردن، هاوتاکردن، هاوتەرازکردن
balanced	هاوسەنگ، هاوتا، هاوتەراز
balanced-bridge	پردی هاوسەنگ
balanced-error	هەڵەی هاوسەنگ
ball	گۆ
ball-printer	چاپکەری گۆدار
ban	ڕێگرتن
band	باند، نەوار، شریت
bandwidth	باندبەرینی
banner-(1)	بەیداخ، بەنێر
banner-(2)	سەردێڕی سەرەکی
banner-(3)	سەردێڕسازی
Banner-(4)	بەنێر
C-(1)	"سی"
C-(2)	"سی"
C#	"سی‌شارپ"
C+	"سی‌‌پڵەس"
C++	"سی‌‌پڵەس‌پڵەس"
C:	س‌جووتخاڵ، سی‌-جووتخاڵ
cab-(1)	ژووریله
cab-(2)	درێژکراوەیەکە بۆ پەڕگەیەکی پەستێنراو لە سیستەمەکانی ویندۆزدا
cable	كێبڵ
cache	حەشارگه
cad-	داڕشتن به یارمەتیی كۆمپیۆتەر
caddy	"كەدی" قەباغی سی‌دی
calculate	١ـ ژماردن، هەژمارکردن ٢ـ لێکدانەوە ٣ـ نەخشەدانان، ڕێکخستن
calculation	ژمێركاری، ژمارەكاری، ژماردن، هەژماركردن
calculator	ژمێرەر، ئامێری ژماردن
cancel	هەڵوەشاندنەوه
canonical	باو، بەپێی یاسا
capability	توانا، توانست، توانایی
capacity	١ـ جێگرتن، فراوانی ٢ـ توانایی، توانا
capture	گرتن
card	كارت
case-	سنووق (ی كاڵاڕەقەكانی كۆمپیوتەر).
case(SW)	بار، دۆخ
category	هاوپۆلەكان
CD-ROM-	"سی‌دی‌ـ رام"، دیسکی تیشکی
CD-RW-	(CD-RW)، دیسکی پەستێنراوی لەسەرنووسەنی
central	ناوەندی
certificate	بڕوانامه
challenge/response	بەرەنگاری/ وەڵام
CHAP-	سی‌ئێچ‌ئە‌ی‌پی
character	نووسه
charge	بارگە
charged	بارگەکراو، بارگاوی
charger	بارگاویکەر، بارگەدەر
chart	هێڵكاری
chat	دەمەتەقێ، چات
check	پیاچوونەوە، تێڕوانین
check-box	چوارگۆشەی پیاچوونەوە، خانەی پیاچوونەوە
chip	چیپ، تەڵەزم، تەڵاش
chip-set	کۆمەڵە تەڵەزم
cipher	سفر، سفراندن
circuit	خولگە، کەمەرە، چێوە
class	پۆل
click	كرته، كلیك
client	ڕاژەخواز
clip	گرته، كلیپ، چەپك
clock-rate	تێكڕای لەرە، ‌چركەلەرە، ڕێژەی لەره
clone	لەبەرگرتنەوه، وێکچوو، لێکچوو، وەكخۆی، كلۆن، کتومت
close-(1)	داخستن
close-(2)	نزیک
close-and-open-a-file	کردنەوە و داخستنی پەڕگە
close-button	دوگمەی داخستن
closed-	داخراو
cloud-computing	هەورە پێژمێری، پێژمێریی هەوری
cluster	هێشوو، پۆل، گرووپ
CMOS	(CMOS)، "سی‌مۆس"
code-(1)	كۆد، ڕەمز، نهێنی
code-(2)-(=-program)	١ـ بەرنامە ٢ـ بەرنامەنووسی
code-(3)	نهێنبەندیکردن
codec	(codec)، "کۆدێک"
collapse	١ـ ڕووخان، ڕمان، هەرەسهێنان ٢ـ نووشتانەوە ٣ـ کەوتن
column	ستوون
COM-(1)	(COM)، "كام"
COM-(2)	(COM)، "كام"
COM-(3)	(COM)، "كام"
COM-(4)	(COM)، "كام"
comma	بۆر، كۆما
command	فەرمان
comment-	١ـ ڕوونكردنەوه. ‌  ٢ـ بۆچوون، لێدوان، تێبینی، سەرنج.
common	هاوبەش، باو
Common-Gateway-Interface-(=-CGI)-	ناوبەستی دەرەڕێی هاوبەش
communication	١ـ ڕاگەیاندن، پێگەیاندن ٢ـ پێوەندی ٣ـ هۆی گەیاندن یا پێوەندیگرتن
compact	پەستێنراو
company	بەشگە، هاوبەشگە
compatible	گونجاو، شیاو
compile	وەرگێڕان
compiler	وەرگێڕ
compress	پەستان
computable	ژماردنی، دەتوانێ بژمێردرێت، ژماردەنی
computation	١ـ ژماردن، لێکدانەوە ٢ـ ئەنجامی ژماردنێک
compute-(1)	ژماردن، لێکدانەوە
compute-(2)	پێژمێری، پێژمێرکردن
computer	كۆمپیوتەر، بژمێر، پێژمێر، ژمێرەری ئەلیکترۆنی
computer-abuse	خراپ بەکارهێنانی کۆمپیوتەر
computer-animation	بەجووڵەگەریی کۆمپیوتەری
Computer-Graphics-Interface-(=-CGI)-	ناوبەستی گرافیکی پێژمێر (کۆمپیوتەر)
computer-aided-	بەیاریدەی کۆمپیوتەر، بەیارمەتیی کۆمپیوتەر
CON	(CON)، "کون"
concat	كۆكردنەوه، خستنەسەریەك
conditional-formatting	شێوازکاریی بەمەرج، فۆرماتکردنی بەمەرج
configuration	شێوەپێدان‌
connection	بەستنەوه، پەیوەندی
console-(1)	شێلمان، هەڵگر، تاق، سەردیوار
constant	نەگۆڕ
constructor	بنیاتنەر
content	ناوەڕۆك
content-layout	گەڵاڵەبەندیی ناوەڕۆك
context	١ـ دەق ٢ـ پێکهات، تەنراو، شانە
context-menu	لیستەی پێکهات
continue	درێژەپێدان
control-bus	تێپەڕگەی ڕێكخستن، تێپەڕگەی کۆنترۆڵ
control-panel	پەڕ‌ەی چاودێری
controls	کۆنترۆڵەکان
convert	گۆڕین، گۆڕان
cookie-(=-Cookie)	شەكرۆكە
copy	ڕوونووس،  لەبەرگرتنەوە
copyright	مافی لەبەرگرتنەوە
cost	تێچوون، بەها
count	١ـ ژماردن ٢ـ کۆکردنەوە
counter	ژمێرەر
CPRM-	سی‌پی‌ئار‌ئێم، پاراستنی ناوەڕۆکی ڕاگەیێنە لابردەنییەکان
CPU-	١سی‌پی‌یوو‌ ( یەكەی ڕێکخەری ناوەندی، ڕێکخەری ناوەندی)
crack	شكان، كراك
CRAM-	(CRAM)، سی‌ئار‌ئە‌ی‌ئێم
crash	تێكشكان
crawler	وێبخشۆك
create	ئافراندن، دروستكردن
credit	بایەخ، بڕوا
credit-card	بڕواکارت، کارتی بڕوا، کارتی بایەخ، کارتی قەرز
cron	كارگێڕ
crossover	١ـ پەڕینەوە، بڕین  ٢ـ بڕگا، شوێنی یەکتربڕین
cryptography	نهێنیكردن
CSMA-CD-	سزماسیدی، دەستپێگەیشتنی چەندجارەی وەرگری هەڵگر/ ئاشکراسازیی پێکدادان
CSS	(CSS)، "سی‌ئێس‌ئێس"
CSV-(1)	(CSV)، سی‌ئێس‌ڤی، نرخی بە بۆر جیابوو
CSV-(2)	(جۆرە درێژکراوەیەکی پەڕگە)
ctrl-key	دوگمەی كۆنتڕۆڵ
currency	دراو، پاره
current-(1)	تەزوو، لووزەو (تەزووی کارەبایی)
current-(2)	تایبەتی بە ئێستا، دواژمارە
current-address	دوایین ناونیشان
current-date	ڕێکەوتی ئێستاکە
cursor	جێنیشاندەر
custom	ڕاسپێراو
customize	كڕیارخوازكردن، چاكردن و گۆڕینی شتێك بەپێی خواستی كڕیار
cut	بڕین
CVS	سی‌ڤی‌ئێس، سیستەمی وەشانە هاوکاتەکان
CWIS-	سیستەمی بەرفراوانی كۆگاكردنی زانیارییەكانە لە زانكۆ و پەیمانگاكاندا
cybrarian	كارمەندی كتێبخانەی دیجیتاڵ
cancel	هەڵوەشاندنەوه
canonical	باو، بەپێی یاسا
capability	توانا، توانست، توانایی
capacity	١ـ جێگرتن، فراوانی ٢ـ توانایی، توانا
capture	گرتن
card	كارت
case-	سنووق (ی كاڵاڕەقەكانی كۆمپیوتەر).
case(SW)	بار، دۆخ
category	هاوپۆلەكان
CD-ROM-	"سی‌دی‌ـ رام"، دیسکی تیشکی
CD-RW-	(CD-RW)، دیسکی پەستێنراوی لەسەرنووسەنی
central	ناوەندی
certificate	بڕوانامه
D-(1)	"دی"
D-(2)	"دی"
D:	"دی‌جووتخاڵ"
daemon-(=-demon)	(بنواڕه demon)
dash	کشتەک، تەقەڵ
DAT-(1)-[Data]	(DAT)، دات
data	دراوه، داتا
data-bus	تێپەڕگەی دراوه
data-warehouse	كۆگای دراوه
database	بنكەدراوە ـ بنكەی دراوه
datagram	داتاگرام
date	ڕێكەوت
debug-(1)	ڕاستكردنەوە، هەڵەدۆزین، هەڵەسڕینەوە
debug-(2)	سیخوڕسڕی، سیخوڕسڕینەوە
debugger	هەڵەدۆز، ڕاستكەرەوه، هەڵەسڕ
decode	كۆدهەڵوەشاندنەوه
decoder	كۆدهەڵوەشێنەر
decompile	وەرگێڕاندنەوە
decompiler	وەرگێڕێنەر
decompress	شیتەڵكردنەوە
decryption	ئاشكراكردن
dedicated	تایبەتمەند
default	بنەڕەت
defragment	دێفراگمێنت، یەکخستنی پارچەبەندبووەکان، ڕێكخستن و خستنەپاڵیەكی هەڵگیراوەكانی ناو پەپكە
delete	سڕینەوه
demilitarized-zone-(=-DMZ)	DMZ، ناوچەی سوپالێدەرکراو، ناوچەی بێسوپا، ناوچەی سوپالێکێشراو
demo	پیشاندان
demon-(1)-(=-daemon)	(demon)، دێمۆن، دیمن، تارمایی، شەوه
demon-(2)-(=-daemon)	(demon)، دێمۆن، قوفڵشکێن
dencity	چڕی
denial-	نكۆڵی
depth	قووڵایی
depth-first-search-(=-DFS)	گەڕانی لەپێشدالەقووڵایی
derived	داتاشراو
descend	نزمبوونەوە، هاتنەخوارەوە
descendant	نەوە، وەچە، بەرە، توخم
descender	خوارهاتوو، شۆڕبوو
descending	داشۆڕی، داکشاوی، نزمبوونی، هاتنەخواری
description	نیشانەهەڵدان، وەسفکردن، وەسف
design	داڕشتن
desire	داخوازی، خواست
desktop	ڕوومێز
desktop-computer	كۆمپیۆتەری ڕوومێز
destructor	لەناوبەر
detail	وردی، وردەکاری
device	ئامێر
device-driver	ئامێروەگەڕخەر
DHCP	پرۆتۆکۆلی ڕێکخستنی خانەخوێی بزۆک
DHTML	زمانی هێمادانانی سەروودەقی بزۆک
diagram	پێنوێن، خشتە، نوانە
dial	١ـ ژمارەگر ٢ـ ژمارەگرتن
dial-up	١ـ ژمارەگری ٢ـ ژمارەگریکردن
digit	ڕەنووس
digital	دیجیتاڵ، ڕەنووسی
digital-audio-disk-(=-DAD)	دیسکی دەنگیی ڕەنووسی، سی‌دی‌ی دەنگی
digital-audio-tape-(=-DAT)	شریتی دەنگیی ڕەنووسی، "دات"
digital-technique-	تەكنیكی ژمارەیی، تەکنیکی ڕەنووسی
dimension	١ـ دووری، لا (پانی و درێژی و ئەستووری) ٢ـ لاکان ٣ـ ڕادە ٤ـ مەودا، گرنگی
direct	ڕاستەوخۆ
direction	١ـ بەڕێوەبردن، سەرپەرشتی ٢ـ ناونیشان ٣ـ فەرمان ٤ـ ڕێباز، ڕێڕەو ٥ـ لا، ڕوو، ئاست، ئاراستە
directory	پێڕست
DirectX	(DirectX)، دیرێکت‌ئێکس
disable	١ـ لەكارخستن ٢ـ نەتوانکردن
disk	پەپكە، دیسك
disk-drive-(=-drive-=-disk-unit-=-DD)	دیسکلێخوڕ، دیسکوەگەڕخەر، پەپکەلێخوڕ، پەپکەوەگەڕخەر
display	پیشاندان
distribution	دابەشكردن
DLL-(Dynamic-Link-Library)	پەرتووكخانەی بەستەری بزۆك
DNS-(=-Domain-Name-System)	سیستەمی ناوی پاوان
document	بەڵگەنامه
domain	دۆمەین، پاوان
domain-name	ناوی دۆمەین، ناوی پاوان
done	کراو، جێبەجێکراو
dongle	کڵۆمی سەختەواڵە
DOS-(1)-	(DOS)، دۆس، سیستەمی کارپێکردنی دیسکی
DOS-(2)-(=-MS-DOS)	(DOS)، دۆس، ئێم‌ئێس‌دۆس (کورتەی ناوی بازرگانیی " MS-DOS ")
DOS-(3)	(DOS)، دۆس
dot-(.)	خاڵ
double	دووئەوەنده
download	داگرتن
draft	پێشنووس، ڕەشنووس
drag-and-drop-	ڕاكێشان و فڕێدان
drawing	وێنەكێشان
drive-(1)-	١ـ دیسکوەگەڕخەر، دیسکلێخوڕ، دیسکئاژۆ ٢ـ نەوار "شریت" لێخوڕ ٣ـ دەزگاوەگەڕخەر، دەزگالێخوڕ، لێخوڕ ٤ـ وەگەڕخستن، لێخوڕین، ئاژۆتن، وەگەڕخستنی دەزگا
drive-(2)	١ـ بزواندن ٢ـ وەگەڕخستن
driver	وەگەڕخەر
driving-licence	كارتی لێخوڕین، لێخوڕنامە، ئاژۆتننامه، مۆڵەتی لێخوڕین
dual	دووان، دووانه
DVD-(=-digital-video-disc-=-digital-versatile-disc)	دی‌ڤی‌دی
DVD-burner	دی‌ڤی‌دی سووتێنەر
DVD-Reader	دی‌ڤی‌دی خوێنەر
dynamic	بزۆك، بەجووڵە، جووڵەدار،
dynamic-address-translation-(=-DAT)	وەرگێڕانی ناونیشانی بزۆک
debug-(1)	ڕاستكردنەوە، هەڵەدۆزین، هەڵەسڕینەوە
debug-(2)	سیخوڕسڕی، سیخوڕسڕینەوە
debugger	هەڵەدۆز، ڕاستكەرەوه، هەڵەسڕ
decode	كۆدهەڵوەشاندنەوه
decoder	كۆدهەڵوەشێنەر
decompile	وەرگێڕاندنەوە
decompiler	وەرگێڕێنەر
decompress	شیتەڵكردنەوە
decryption	ئاشكراكردن
dedicated	تایبەتمەند
default	بنەڕەت
defragment	دێفراگمێنت، یەکخستنی پارچەبەندبووەکان، ڕێكخستن و خستنەپاڵیەكی هەڵگیراوەكانی ناو پەپكە
delete	سڕینەوه
demilitarized-zone-(=-DMZ)	DMZ، ناوچەی سوپالێدەرکراو، ناوچەی بێسوپا، ناوچەی سوپالێکێشراو
demo	پیشاندان
E	"ئی‌"
E-	"ئی"
e-commerce	بازرگانیی ئەلەكترۆنی
e-mail	پۆستی ئەلەكترۆنی، ئیپۆست، ئیمەیل، ئیمێڵ
eBook	پەڕتووكی ئەلەكترۆنی، كتێبی كۆمپیوتەری، ئی‌بووك
ECDL	كارتی لێخوڕینی كۆمپیوتەر لە ئەورووپا ـ لێخوڕنامەی ئەورووپیی كۆمپیوتەر
echo-(1)	ئێكۆ، زایەڵه
echo-(2)	پەیام
echo-(3)	١ـ زایەڵە، گەڕانەوە (زاراوەی گشتی بەتایبەت سەبارەت بە گەڕانەوەی دەنگ) ٢ـ زایەڵەکردن، گەڕانەوە (گەڕانەوەی هێما لە ڕێڕەوی ناردراودا)
ECHO-(4)	ئێكۆ
ECP-	(ECP)، ئی‌سی‌پی‌، دەرگا بە لێهاتووییەکانی پەرەسەندوو
edit-(1)	دەستكاری، دەستكاریكردن
edit-(2)	١ـ هەڵەبڕی، هەڵەبڕیکردن (لە گۆڤار و ڕۆژنامە)
edit-(3)	بژار، بژارکردن، هەڵوەژارتن (ڕێکوپێککردنی فیلم)
editor-(1)	دەستكاریكەر
editor-(2)	١ـ هەڵەبڕ (هەڵەچن و هەڵەگیری گۆڤار و ڕۆژنامە) ٢ـ سەرنووسەر (ی گۆڤار و ڕۆژنامە) ٣ـ نووسەر (ی گۆڤار و ڕۆژنامە) ٤ـ  نووسەر (پرۆگرامێکە کە بۆ نووسین بەکار دەچێت) ٥ـ پێداچوو، ڕاستکەرەوە
editor-(3)	١ـ بژارکەر، هەڵوەژار (کەسێ کە کاری ڕێکوپێککردن و ئامادەکردنی فیلمێک دەکات) ٢ـ بژارکەر، هەڵوەژار (جۆرە پرۆگرامێکە‌ کە بۆ ڕێکوپێککردن و بڕین و چاککردن و ئامادەکردنی فیلم بەکار دەچێت)
edu	١ ـ پەروەردە، فێركردن ٢ـ درێژکراوەی ئەو ناونیشانە وێبییانەی کە بە فێرکردنەوە خەریکن، وەک چۆن (com.) و (org.) هەیە
effect	کاریگەری
element	توخم، ئەندام، بەش
email-group	گرووپەپۆستی ئەلەكترۆنی
emulator	لاساییكەرەوە
enable	تواناپێدان ـ توانپێدان
encode	١ـ نهێنبەندی ٢ـ نهێنبەندیکردن
encoder	بەكۆدكەر
encryption	نهێنیكردن
encyclopedia	زانیارینامە
end-	كۆتایی
energy	وزه
engine	بزوێن
enter-(1)	١ـ تێکەری ٢ـ کردنەناو ٣ـ چوونەناو ٤ـ تێکردن، خستنەناو ٥ـ نووسین و تێخستن، خستنەناوی کۆمپیوتەر ٦ـ تۆمارکردن (لە کۆمپیوتەردا)
Enter-(2)	دێڕگێڕ
enterprise-	پرۆژەی ئابووری
entity	پێكهاتە، بوون
environment	ژینگه، دەورووبەر
EPP	(EPP)، ئی‌پی‌پی، دەرگای هاوتەریبی نووژەنبوو
erase	سڕینەوە
error	هەڵه
escape	دەرباز
Escape-sequence	ڕیزەدەربازبوون
Ethernet	(Ethernet)، ئێسەرنێت
EtherTalk	(Ether Talk)، تێتێر تاک
event	ڕووداو
event-counter	ڕووداوژمێر
event-file	پەڕگەی ڕووداو
exa-(=-E-)	"ئێگزا-"
exabit-(=-Eb)	"ئێگزابیت"
exabyte-(=-EB)	"ئێگزابایت"
exceed	زیاتربوون یان ڕۆیشتن لە (سنوور، پەیڕەو)، تێپەڕبوون لە
execute	بەجێهێنان، جێبەجێکردن، کردن
exit-(1)	١ـ دەرگە، دەرگا، جێگەی چوونەدەرەوە ٢ـ دەرچوون، چوونەدەرەوە، ڕۆیشتن
EXIT-(2)	ئێگیزت
exit-documentation	بەڵگەسازی لە کاتی چوونەدەرەوە
expand-(1)	١ـ کردنەوە، بڵاوکردنەوە، ڕاکێشان ٢ـ کشاندن، ڕاکێشان، گەورەکردن درێژکردنەوە ٣ـ فراوانکردن، پانکردن، پەرەپێسەندن
EXPAND-(2)	"ئێکسپێند"
expert	پسپۆڕ
exploit	قۆزتنەوه
explorer	دۆزەر، گەڕاڵ
export	هەنارده، هەناردن
extensible	شیاوی پەرەسەندن، پەرەسەندنێتی
extension	١ـ درێژکردنەوە، درێژبوونەوە ٢ـ مەودا ٣ـ  پاشبەند، لق، پەل، پاشکۆ ٤ـ پەرە، پەرەسەندن ٥ـ درێژكراوه
external	دەرەكی
external-bus	تێپەڕگەی دەرەکی
extract	دەرهێنان
editor-(2)	١ـ هەڵەبڕ (هەڵەچن و هەڵەگیری گۆڤار و ڕۆژنامە) ٢ـ سەرنووسەر (ی گۆڤار و ڕۆژنامە) ٣ـ نووسەر (ی گۆڤار و ڕۆژنامە) ٤ـ  نووسەر (پرۆگرامێکە کە بۆ نووسین بەکار دەچێت) ٥ـ پێداچوو، ڕاستکەرەوە
editor-(3)	١ـ بژارکەر، هەڵوەژار (کەسێ کە کاری ڕێکوپێککردن و ئامادەکردنی فیلمێک دەکات) ٢ـ بژارکەر، هەڵوەژار (جۆرە پرۆگرامێکە‌ کە بۆ ڕێکوپێککردن و بڕین و چاککردن و ئامادەکردنی فیلم بەکار دەچێت)
edu	١ ـ پەروەردە، فێركردن ٢ـ درێژکراوەی ئەو ناونیشانە وێبییانەی کە بە فێرکردنەوە خەریکن، وەک چۆن (com.) و (org.) هەیە
effect	کاریگەری
element	توخم، ئەندام، بەش
email-group	گرووپەپۆستی ئەلەكترۆنی
emulator	لاساییكەرەوە
enable	تواناپێدان ـ توانپێدان
encode	١ـ نهێنبەندی ٢ـ نهێنبەندیکردن
encoder	بەكۆدكەر
encryption	نهێنیكردن
encyclopedia	زانیارینامە
end-	كۆتایی
energy	وزه
engine	بزوێن
F1-–-F12	دوگمەی نەخشە
fabricate	دروستکردن، پێکنان (بەهۆی کارگە)
facsimile-(=-FAX)	فاكس
false	١ـ ناتەواو، درۆ، هەڵە ٢ـ درۆزنە، ساخته، قەڵب‌
false-alarm	وریاکردنەوەی ساختە
false-code	کۆدی ناتەواو، کۆدی هەڵە
false-error	هەڵەی ساختە
FAQ	پهد ـ پرسیاری هەمیشه دووباره ـ پرسیار و وەڵام
FAT	FAT، فەت
FAT32	(FAT32)، فەت٣٢
favorite	دڵخواز، پەسند، هەڵبژارده
FAX-(=-facsimile-=-fax)	فاکس، فەکس
fax-=-FAX	بنواڕە FAX
FDDI	(FDDI)، ئێف‌دی‌دی‌ئای
feed	١ـ خورد، خۆراک ٢ـ خۆراکپێدان، خۆراندن ٣ـ پێشبردن
feed-track	هێڵگەی پێشبەری (لە شریتی کاغەزیدا)
feedback	١ـ پێڕاگەیاندنەوە ٢ـ پاشخوارد، پاشخورد، وەڵامدانەوە بە وتە یا کردار، هەستپیشاندان بەرانبەر کردار یا ڕەفتارێک
feedback-amplifier	وزەپێدەری پاشخوردی
feedback-circuit	خولگەی پاشخوردی
feedback-control	کۆنترۆڵی پاشخوردی
feeder	١ـ پێشبەر ٢ـ خۆراکدەر
feeder-cable	کێبڵی خۆراک
feedforward	پێشخورد، پێشخوارد
feedforward-hole	کونی پێشبەری (لە کاغەزدا)
feedforward-register	تۆماری پێشخوردی
feedline	هێڵەخۆراك
female	مێینە
ferric-RAM-(=-FRAM)	"فێڕیک‌ ڕام"
field	بوار، خانه
file	پەڕگه، فایل
file-allocation-table-(=-Fat)	خشتەی تەرخانی پەڕگە
file-system	سیستەمی پەڕگە
filter-	پاڵێو
find	دۆزینەوە
finger	"فینگر"
finish	١ـ تەواو، کۆتایی ٢ـ تەواوکردن، کۆتاییپێهێنان
firewall	ئاگرەدیوار
FireWire-	"فایروایر"
firmware	پتەوواڵە، "فیرم‌وەیر"
fixed	جێگیر، جێگیرکراو، جێگیربوو، چەسپاو، دیاریکراو، سەقامگیر، نەجووڵاو، نەگۆڕ، قیت، وەستاو، پتەو
flag	١ـ ئاڵا، نیشانه ٢ـ نیشانەنوێن
flash	فلاش
float	كەرت
Floating-point-number	ژمارەی كەرتی، ژمارەی بۆرـ‌ سەرئاو، ژمارەی بۆرسەرئاو
floppy-	دیسكی نەرم
folder	بوخچه
font	جۆرەپیت
footer	پێپەڕە
footnote	پەراوێز‌، پانووس
force	هێز، زۆرلێكردن
foreground	پێشبنەما
foreign-	بیانی
format	فۆرمات
forth	(forth)، فۆرت
forum	مەكۆ
forward-(1)	بینێرە بۆ
forward-(2)	بەرڕۆیی، پێشڕۆیی
forward-(3)	١ـ بەرڕۆ، پێشڕۆ، ڕووبەپێش ٢ـ ڕاستەوخۆ
forward-difference	جیاوازیی پێشڕۆ، جیاوازیی بەرڕۆ
forward-error-recovery	چێکردنەوەی هەڵە لە پێشدا، چێکردنەوەی پێشگیرانەی هەڵە
FQDN	FQDN، (ناوی تەواوی دۆمەین لە ئینتەرنێتدا. بۆ وێنە www.zkurd.org)
fragment-	١ـ پارچە، لەت، کەرت، کوت، "فراگمنت" ٢ـ  پارچەبەندیکردن، لەتبەندیکردن
frame	چوارچێوە
free	١ـ ئازاد، سەربەست ٢ـ خۆڕایی ٣ـ ڤالا، بەتاڵ
free-software	نەرمەواڵەی خۆڕایی، نەرمەواڵەی ئازاد
freemail	پۆستی ئازاد
freeware	خۆڕاییواڵە، پرۆگرامی خۆڕایی، نەرمەواڵەی خۆڕایی
frequency	دووبارە، شەپۆل ـ لەرە، لەرەلەر
front	پێش، بەرە
FSB	FSB
FSF	FSF
FTP	"ئێف‌تی‌پی"، کۆنووسی گواستنەوەی پەڕگە
function	١ـ نەخشە، ئەرک، کردار ٢ـ پابەند
function-call	بانگهێشتكردنی نەخشە
function-key	كلیل لەسەر تەختەكلیل كە كورتكراوەی كرداری دیاریكراون
functional	١ ـ نەخشەیی، ئەرکی، کرداری ٢ـ پابەندی
fuzzy	لێڵ، ناڕوون، نائاشکرا
fuzzy-logic	ژیربێژیی لێڵ، دەستەواژەی فوزی
FYI-(=-For-Your-Information)	"بۆ زانیاریت"، كورتكراوەیە بۆ پێدانی ئاگادارییەك لە هەبوونی زانیاری
FDDI	(FDDI)، ئێف‌دی‌دی‌ئای
feed	١ـ خورد، خۆراک ٢ـ خۆراکپێدان، خۆراندن ٣ـ پێشبردن
feed-track	هێڵگەی پێشبەری (لە شریتی کاغەزیدا)
feedback	١ـ پێڕاگەیاندنەوە ٢ـ پاشخوارد، پاشخورد، وەڵامدانەوە بە وتە یا کردار، هەستپیشاندان بەرانبەر کردار یا ڕەفتارێک
feedback-amplifier	وزەپێدەری پاشخوردی
feedback-circuit	خولگەی پاشخوردی
feedback-control	کۆنترۆڵی پاشخوردی
feeder	١ـ پێشبەر ٢ـ خۆراکدەر
feeder-cable	کێبڵی خۆراک
feedforward	پێشخورد، پێشخوارد
feedforward-hole	کونی پێشبەری (لە کاغەزدا)
feedforward-register	تۆماری پێشخوردی
feedline	هێڵەخۆراك
female	مێینە
ferric-RAM-(=-FRAM)	"فێڕیک‌ ڕام"
game	یاری، وازی، گەمە
gate	دەروازه
gateway	دەرەڕێ
GB/sec-	١ـ گیگابایت لە چرکەدا ٢ـ گیگابیت لە چرکەدا ٣ـ گب/ چ
Gbps-(=-GB/sec)	گ.ب.ل.چ
general	گشتی
generate	بەدیهێنان
GIF-(1)	"گیف"، فۆرماتی ناوبەستی گرافیک
GIF-(2)	(جۆرە درێژکراوەیەکی پەڕگە)
gig-=-giga-	بنواڕە -giga
giga-	"گیگا-"، "جیگا-"
global	جیهانی
GNU	GNU، "گنو"
Gopher	Gopher، "گوفێر"
graph	١ـ گراف، نیگارە ٢ـ نەخشەک، هێڵکاریی ڕوونکردنەوە
graphic	گرافیك، نیگارەیی
graphic-card	كارتی گرافیك، کارتی نیگارە
graphical-user-interface	ناوبەستی نیگارەییی بەکارهێنەر، نێوانەڕووی گرافیکیی بەکاربەر، "جی‌یوو‌ئای"
group	گرووپ، دەستە، پۆل
guarantee	دەستەبەری
guest	میوان
guestbook	پەڕاوی میوان
GUI	ڕووكاری وێنەسازراو بۆ وتووێژ لەگەڵ بەكارهێنەر
GUID	تاكە كۆدێكی جیاكەرەوەی گشتییە، كۆدێكی بێ هاوتایە بۆ جیاكردنەوە
gutter	پەراوێزی ستوون
graphic	گرافیك، نیگارەیی
graphic-card	كارتی گرافیك، کارتی نیگارە
graphical-user-interface	ناوبەستی نیگارەییی بەکارهێنەر، نێوانەڕووی گرافیکیی بەکاربەر، "جی‌یوو‌ئای"
group	گرووپ، دەستە، پۆل
guarantee	دەستەبەری
guest	میوان
guestbook	پەڕاوی میوان
GUI	ڕووكاری وێنەسازراو بۆ وتووێژ لەگەڵ بەكارهێنەر
GUID	تاكە كۆدێكی جیاكەرەوەی گشتییە، كۆدێكی بێ هاوتایە بۆ جیاكردنەوە
gutter	پەراوێزی ستوون
hack	١ـ "هەک" ٢ـ خۆترنجاندن ٣ـ دزینی زانیاری ٤ـ چوونەژوورەوەی ڕێنەدراو بە سیستەم، خۆترنجاندن بە سیستەم، دزەکردن بە سیستەم ٥ـ دزە ٦ـ ئازارد‌انی کۆمپیوتەری
hacker	١ـ "هەکر"، خۆترنجێنەر، دزەکەر ٢ـ دزی زانیاری، زانیاریدز ٣ـ ئازاردەری کۆمپیوتەری ٤ـ کۆمپیوتەردۆست، کۆمپیوتەرچی، پێژمێرچی، دراوەچی
hacking	١ـ دزینی زانیاری، زانیاریدزی ٢ـ ئازاردانی کۆمپیوتەری ٣ـ پێژمێردۆستی ٤ـ خۆترنجان
handheld-computer	كۆمپیوتەری دەستی
hangup	١ـ داخستن (هێڵی تەلەفۆن) ٢ـ کپبوو، گیرکردوو، وەستاو
hard-disk	دیسكی ڕەق، پەپكەڕەقە
hard-disk-drive-	وەگەڕخەری دیسکی ڕەق، "ئێچ‌دی‌دی"
hardcode	قورسە ڕژێم
Hardware	ڕەقەواڵه، ڕەقەئامێر، سەختەواڵە ، كاڵاڕەق
hardware-bridge	پردی ڕەقەواڵە
hash	وردكردن
hash-(#)	پەیژە
header-(1)	١ـ دەستپێک ٢ـ ناونیشان
header-(2)	سەرپەڕە
heap	شوێنی هەڵگرتن، بیرگەی بزۆك
height	بەرزی
help-(1)	یارمەتی، ڕێنوێنی
help-(2)	هێڵپ
help-command	فەرمانی ڕێنوێنی، فەرمانی یارمەتی
help-file	پەڕگەی ڕێنوێنی، پەڕگەی یارمەتی، پەڕگەی یارمەتیدەر، پەڕگەی ڕێنوێن
hertz	هێرتز، یەکەی پێوانی لەرە
hesitation	درەنگ
hexadecimal	ژمارەی شازدەیی
hexadecimal-system	ڕژێمی شانزده ژمارەیی
hibernate	دۆخەپشوو
hidden	شاراوە، پەنهان
hidden-defect	خەوشی شاراوە
hide	شاردنەوە
history	مێژوو
hits	بەركەوتن
hole	كون
home	ماڵەوە
home-page-(=-homepage)	ماڵپەڕ
horizontal	ئاسۆیی
host	خانەخوێ
host-adapter	گونجێنەری خانەخوێ
host-computer	کۆمپیوتەری خانەخوێ
host-drive	وەگەڕخەری خانەخوێ، دیسکوەگەڕخەری خانەخوێ
host-language	زمانی خانەخوێ
host-system	سیستەمی خانەخوێ
hot	داخ
hot-fix-=-hotfix	hot fix)، چارەساز، چارەكەر
hot-key	(hot key)، کلیلی داخ، دوگمەی خێرا، خێرادوگمە
hot-plug	hot plug
hot-spot	(hotspot)، خاڵی داخ
hot-swap	hot swap، جێگرەوەی داخ
hotSync	hotSync
HTML	(HTML)، ئێچ‌تی‌ئێم‌ئێڵ، زمانی نیشانەدانانی سەروودەق
HTTP	ئێچ‌تی‌تی‌پی، پرۆتۆکۆلی گواستنەوەی سەروودەق
hub	تۆپە
hyperlink	سەرووبەستەر
hyperlink-address	ناونیشانی سەرووبەستەر
hypermedia	سەروو‌ڕاگەیێنەکان
hyperpage	سەرووپەڕە
hyperpaging	سەرووپەڕەپەڕەدانەوه
hypersearch	سەرووگەڕان
HyperTalk	هایپرـ تاک
hypertext	سەروودەق
hyphen	بەستهێڵ، كورتەتەقەڵ
heap	شوێنی هەڵگرتن، بیرگەی بزۆك
height	بەرزی
help-(1)	یارمەتی، ڕێنوێنی
help-(2)	هێڵپ
help-command	فەرمانی ڕێنوێنی، فەرمانی یارمەتی
help-file	پەڕگەی ڕێنوێنی، پەڕگەی یارمەتی، پەڕگەی یارمەتیدەر، پەڕگەی ڕێنوێن
hertz	هێرتز، یەکەی پێوانی لەرە
hesitation	درەنگ
hexadecimal	ژمارەی شازدەیی
hexadecimal-system	ڕژێمی شانزده ژمارەیی
hibernate	دۆخەپشوو
hidden	شاراوە، پەنهان
hidden-defect	خەوشی شاراوە
hide	شاردنەوە
history	مێژوو
IBM	(IBM)، ئای‌بی‌ئێم
ICANN	(ICANN) ئای‌کان
ICMP	(ICMP)، پرۆتۆکۆلی پەیامی کۆنترۆڵی ئینتەرنێت
ICO	(جۆرێک درێژکراوەی پەڕگە)
icon	وێنۆچكە
ICQ	(ICQ)، ئای‌سیک‌یو، ئای‌سی‌کیو
IDE-(1)	(IDE)، ئای‌دی‌ئی
IDE-(2)	ژینگەیەكی تەواو بۆ پەرەپێدانی بەرنامەكان
identification	پێناس، ناسنامە
identifier	ناسێنەر، پێناسدیاریكەر
IGMP	(IGMP)، ئای‌جی‌ئێم‌پی، پرۆتۆکۆلی گرووپی بەڕێوەبەرایەتیی ئینتەرنێت
IIS	(IIS)، ئای‌ئای‌ئێس، دەبڵ‌ئای‌ئێس، ڕاژەکاری زانیاریی ئینتەرنێت
illegal	نایاسایی، ڕێپێنەدراو
iMAC	(iMAC)، ئای‌مەک
image	وێنە
imagine	وێناکردن، بۆچوون
impedance	بەرگریی ڕواڵەتی، بەرگریی ڕووکەشانە، ئیمپێدانس
implies	ئەگرێتەخۆ
import	١ـ هێنان، هاوردن، ٢- هاوردە
improve	چاککردن، باشکردن، چاکترکردن، پەرەپێسەندن، پێشخستن
improved	چاکبوو، باشبوو
improved-version	وەشانی چاکبوو، وەشانی باشبوو
improvment	باشی، چاکی
increment-	پەرە، زۆربوون
index	١ـ پێڕست ٢ـ نوانە، پێنوێن، نیشاندەر، پیشاندەر
index-bilding-	چێکردنی نوانە، نوانەچێکەری، نوانەسازی
indexed	نوانەدار
indexed-access	دەستپێگەیشتنی نوانەدار
indexed-address	ناونیشانی نوانەدار
indexed-file	پەڕگەی نوانەدار
indexed-instruction	ڕێکارنامەی نوانەدار، فەرماننامەی نوانەدار
information	زانیاری
information-provider-(=-content-provider-=-IP)	پێکهێنەری زانیاری، بەدەستهێنەری زانیاری
Information-Technology-	تەكنۆلۆژیای زانیاری، پیشەزانیی زانیاری
infrared	ژێرسوور
initialize	نرخی سەرەتایی‌ پێدان، پێدانی نرخی سەرەتایی
input	١ـ تێكردن ٢ـ تێخستە، تێچوو، تێخراو ٣ـ ناوچوونگە
input-(device)	تێخستە، تێچوو، تێخراو، ئامێری تێچوو "تێخراو"، بەناوبەر، ئامێری بەناوبەر
input-area	ناوچەی تێخستە (تێچوو)
input-block	بەربەستی تێخستە (تێچوو)
input-buffer	نێوانگری تێخستە (تێچوو)
input-bus	تێپەڕگەی تێخستە (تێچوو)
insert	تێخستن
install	دامەزراندن، دامەزران
InstallShield-	قەڵغانی دامەزراندن
instance-	نموونە
instant	دەستبەجێ
instant-message-	پەیامی دەستبەجێ
instruction	ڕێکارنامە، فەرماننامە
insurance	پارێزه
int	بنواڕە integer type
integer	ژمارەی تەواو
integer-type	جۆری تەواو
integration-	تەواوكردن
interactive	كارلێكردن - دوولایەنه
interface	١ـ ڕووکار ٢ـ نێوانەڕوو ٣ـ ناوبەست (واتە وەک ناوبەستێ کە دەتوانێ دوو شت پێکەوە ببەستێتەوە)
internal	ناوەكی
internal-bus	تێپەڕگەی ناوەکی
internet	ئینتەرنێت، ئینترنێت، ئینترنت
intranet	ئینترانێت
invite	بانگێشتن، بانگهێشتكردن
IP-(1)	(IP)، ئای‌پی، پرۆتۆکۆلی ئینتەرنێت، کۆنووسی ئینتەرنێت
IP-(2)	بنواڕە information provider
IP-address-	ناونیشانی ئای‌پی، ناونیشانی کۆنووسی ئینتەرنێت
ISBN-	ژمارەی سپاردن، پێوەرەژمارەی نێونەتەوەییی کتێب
ISDN	(ISDN)، ئای‌ئێس‌دی‌ئێن، ڕایەڵەی ئای‌ئێس‌دی‌ئێن، ڕایەڵەی ڕەنووسیی ڕاژە هاوکۆکان
issue	١- ئەنجام، بەرهەم ٢- دەرکردن (ڕۆژنامە، گۆڤار) ٣- بڵاوکراوە (ڕۆژنامە، گۆڤار) ٤- ژمارە (ی ڕۆژنامە و گۆڤار)
IT-	تەكنۆلۆژیای زانیاری
italic	لار
item	دانە، بڕگە
iTunes	ڕاژەگەری (خزمەتگوزاری)ی مۆسیقایە لەڕێگەی نەرمەواڵەیەکەوە كۆمپانیای ئەپڵ پێشكەشی دەكات
image	وێنە
imagine	وێناکردن، بۆچوون
impedance	بەرگریی ڕواڵەتی، بەرگریی ڕووکەشانە، ئیمپێدانس
implies	ئەگرێتەخۆ
import	١ـ هێنان، هاوردن، ٢- هاوردە
improve	چاککردن، باشکردن، چاکترکردن، پەرەپێسەندن، پێشخستن
improved	چاکبوو، باشبوو
improved-version	وەشانی چاکبوو، وەشانی باشبوو
improvment	باشی، چاکی
increment-	پەرە، زۆربوون
index	١ـ پێڕست ٢ـ نوانە، پێنوێن، نیشاندەر، پیشاندەر
index-bilding-	چێکردنی نوانە، نوانەچێکەری، نوانەسازی
indexed	نوانەدار
indexed-access	دەستپێگەیشتنی نوانەدار
indexed-address	ناونیشانی نوانەدار
J2EE	J2EE
Jackson-structured-programming-	پرۆگرامکردنی پێکهاتەی جەکسۆن
jaggies	زیگزاگ، لابەلا
jar-(1)	(زەبروەشاندنی توند لە ئامێر و دەزگا)
jar-(2)	ئەرشیڤی جاڤا
Java	جاڤا
JavaScript-	جاڤاسکریپت
JDBC	(JDBC)، جەی‌دی‌بی‌سی، پێکەوەبەستنی بنکەدراوەی جاڤا
JDK	(JDK)، جەی‌دی‌کەی
JHTML-	(JHTML)، جەی‌ئێچ‌تی‌ئێم‌ئێڵ، جاڤا لەناو زمانی هێمادانانی سەروودەق
jini	(jini)، "جینی"
job	كار
Joliet	(Joliet)، جولیت
journal-(1)	١ـ گۆڤار ٢ـ ڕۆژنامە
journal-(2)	١ـ بیرنامە، یادنامەی ڕۆژانە، یادداشت ٢ـ پەڕاوی بیرنامە
journal-(3)	ژوورنال
journal-(4)	ژوورنال
journal-(5)	ڕاگرە یا جێی ڕاگیربوونی تەوەر (مەکینەگەری)
JPEG	(JPEG)، جەی‌پێج
JRE	(JRE)، ژینگەی ماوەی گەڕانی جاڤا
JSP-(2)	(JSP)، جەی‌ئێس‌پی، پەڕەی ڕاژەکاری جاڤا
jumper	بازدەر
junk-(1)	خڕەوپڕە، شڕەوپڕەی کۆمپیوتەری
junk-(2)	بێگیان، مانگی دەستکردی مردوو
junk-(3)	١ـ بێکەڵک ٢ـ بێگیان ٣ـ بێکەڵککردن ٤ـ بێگیانکردن
junk-a-file	سڕینەوەی پەڕگە
junk-mail	پۆستی بێكەڵك
justify	هاوڕێکی، هاوستوونی
JVM	(JVM)، جەی‌ڤی‌ئێم
journal-(3)	ژوورنال
journal-(4)	ژوورنال
journal-(5)	ڕاگرە یا جێی ڕاگیربوونی تەوەر (مەکینەگەری)
JPEG	(JPEG)، جەی‌پێج
JRE	(JRE)، ژینگەی ماوەی گەڕانی جاڤا
JSP-(2)	(JSP)، جەی‌ئێس‌پی، پەڕەی ڕاژەکاری جاڤا
jumper	بازدەر
junk-(1)	خڕەوپڕە، شڕەوپڕەی کۆمپیوتەری
junk-(2)	بێگیان، مانگی دەستکردی مردوو
junk-(3)	١ـ بێکەڵک ٢ـ بێگیان ٣ـ بێکەڵککردن ٤ـ بێگیانکردن
junk-a-file	سڕینەوەی پەڕگە
junk-mail	پۆستی بێكەڵك
justify	هاوڕێکی، هاوستوونی
K	كیلۆ
KDE	کەی‌دی‌ئی
kernel	ناووك
key	١ـ كلیل ٢ـ دوگمە
keyboard	تەختەكلیل
keyword	کلیلەوشە
kill	لابردن، سڕینەوە
kill-file	لابردنی پەڕگە، سڕینەوەی پەڕگە
kilo	كیلۆ
kilobit-per-second-	کیلۆبیت لە چرکەدا
kilohertz-	کیلۆهرتز
kit	١ـ كەرەسە ٢ـ کەرەسەدان، سنووقی جێی کەرەسە و ئامێر ٣ـ سیستەمێکی پێژمێری کە لەلایەن بەکارهێنەرێکەوە چێ کراوە
lable	نیشانە
LAN	(LAN)، "لا‌ن"، ڕایەڵەی ناوخۆیی، ڕایەڵەی داپۆشەرخۆجێیی
LAN-card	کارتی "لان"
landscape-mode	شێوازی ئاسۆیی بۆ چاپکردن
laptop	لاپتۆپ، سەرئەژنۆیی
laptop-computer	کۆمپیوتەری سەرئەژنۆیی
launch	داگیرساندن
layer	چین
layout	١ـ گەڵاڵەبەندی ٢ـ کڵێشە، نەخشان، ڕووی دەرەوەی تەنێک
LCP	(LCP)، پرۆتۆکۆلی کۆنترۆڵی بەستەر
LDAP	(LDAP)، ئێڵ‌دی‌ئەی‌پی
lease	كرێ
level	ئاست
library	ژێدەرگه
license	ڕێپێدان، ڕێپێنامە، مۆڵەت
link	بەستەر
link-control-procedure-	شێوازی کۆنترۆڵبەستەر، شێوازی کۆنترۆڵی هێڵی بەستەر
linker	لێكبەستەر
liquid	تراو، ڕاو، ئاوەکی، شلە
liquid-crystal-display-	پیشانگەری بلوورینی تراو
load	باركردن
local	ناوچە، خۆماڵی، خۆجێیی
log-(1)	(بنواڕە log-in و log-out)
log-(2)	ڕووداوتۆمارگەری
log-(3)	ڕووداوتۆمارکردن
log-in-(1)	چوونەژوورەوە، چوونەژوورەوە بە سیستەم
log-in-(2)	پێوەندسازی، گرێدانگەری
log-in-(3)	١ـ چوونەناوی سیستەم ٢ـ پێکهێنانی پێوەندی ٣ـ پێکهێنانی ڕاستەوخۆی پێوەندی
log-in-(4)	بنواڕە sign in
log-out-(1)	دەرچوون، پچڕانی پێوەندی، دەرچوون لە سیستەم
log-out-(2)	پچڕانسازی، پچڕانگەری
logging	ڕووداوتۆماری، ناونووسی
logging-of	کوژاندنەوەی سیستەم
logging-on	بەکارخستنەوەی سیستەم
logic	ژیربێژی
login	چوونەژوورەوە
logout	١ـ دەرچوون ٢ـ دەرنووسی
long	درێژ، دوور
loop	كلو، گەو، ئاڵقه
loudspeaker	بڵندگۆ، بەرزەبێژ
LPT	(LPT)، ئێڵ‌پی‌تی
license	ڕێپێدان، ڕێپێنامە، مۆڵەت
link	بەستەر
link-control-procedure-	شێوازی کۆنترۆڵبەستەر، شێوازی کۆنترۆڵی هێڵی بەستەر
linker	لێكبەستەر
liquid	تراو، ڕاو، ئاوەکی، شلە
liquid-crystal-display-	پیشانگەری بلوورینی تراو
load	باركردن
local	ناوچە، خۆماڵی، خۆجێیی
log-(1)	(بنواڕە log-in و log-out)
log-(2)	ڕووداوتۆمارگەری
log-(3)	ڕووداوتۆمارکردن
log-in-(1)	چوونەژوورەوە، چوونەژوورەوە بە سیستەم
log-in-(2)	پێوەندسازی، گرێدانگەری
log-in-(3)	١ـ چوونەناوی سیستەم ٢ـ پێکهێنانی پێوەندی ٣ـ پێکهێنانی ڕاستەوخۆی پێوەندی
log-in-(4)	بنواڕە sign in
macro	پۆلەفرمان
magnet	موگناتیس
magnetic	موگناتیسی
mail	پۆست
mailbox	نامەدان
main	سەرەكی
malware	زیانەواڵه
manual	١ـ ڕێبەر، دەستکار ٢ـ پەیڕەونامە، ڕێڕەونامە، نامیلکەی ڕێنوێنی، ڕێنوێننامە
margin	قەراخ، کەنار، تەنیشت
marker	هێمادانەر، نیشانەلێدەر، نیشانەکەر، ئاماژەکەر
marketing	كڕین و فرۆشتن، بازاڕچێتی
markup-(=-mark-up)	هێمادانان، نیشانەدانان
master	سەردار
media	ڕاگەیێنەکان، ڕاگەیاندنەکان، هۆكاری ڕاگەیاندن، میدیا
media-access-control-(=-MAC)	کۆنترۆڵی دەستپێگەیشتن بە ڕاگەیێنەکان
media-center	ناوەندی ڕاگەیەنەکان
media-drive	وەگەڕخەری ڕاگەیەنەکان
medium	١ـ ناوەند، ناوەندی ٢ـ ڕاگەیێن، میدیا
memory	بیرگە
menu	لیسته، پێڕست
message	پەیام
messenger	پەیامبەر، نامەبەر، تەتەر
method	شێواز، ڕێگا
minicomputer	گچكەبژمێر، کۆمپیوتەری گچکەلە
mirror	ئاوێنە
mobile	جووڵاو، بزۆک، گەڕۆک
mobile-phone-	تەلەفۆنی گەڕۆک، تەلەفۆنی دەستی، تەلەفۆنی بزۆک
mode	دۆخ، بار، شێواز
model	مۆدێل، نموونە
modem	مۆدێم
module	یەكەی سەربەخۆ، مۆدول
monitor-(1)	مۆنیتۆر، پیشانگەر، پەردەپیشان
monitor-(2)	چاودێر، مۆنیتۆر
monitor-(3)	١ـ چاودێر، بەرنامەی چاودێر (لە سیستەمی کارپێکردندا، بەرنامەی کۆنترۆڵی فەرمانەکان) ٢ـ چاودێریکردن
monitor-(4)	١ـ چاودێر، دەزگای چاودێری (لە پێوانی خۆکاردا، ئامێرێ کە بە شێوەیەکی بەردەوام، ڕادەی یەک یان چەند بڕێک دەپێوێ) ٢ـ چاودێریکردن، ئاگالێبوون
monitoring-	چاودێری
motherboard-	تەختەی سەرەكی، تەختەدایک، دایکەتەختە
mount	جێگیركردن، بەستن، گرێدان
mouse	مشك
mouse-pad	ژێرەمشك
move	جووڵان
move-down	بۆخوارگوێزانەوە، بزواندن بۆ خوارەوە
move-up	بۆسەرگوێزانەوە، بزواندن بۆ سەرەوە
MS-Office	مایکرۆسۆفت ئۆفیس
multi	فرە، چەندین، چەند
multicast	فرەپەخش، فرەوەشان
multilanguage	فرەزمان
multimedia	فرەڕاگەیێنەکان، فرەڕاگەیەنەکان، ڕەنگاڵە
mute	کپاندن، کپکردن، دەنگبڕین
MySQL	مای‌ئێس‌كیو‌ئێڵ، مای‌سیكوێل، جۆرێكە لە بنکەدراوە
media-center	ناوەندی ڕاگەیەنەکان
media-drive	وەگەڕخەری ڕاگەیەنەکان
medium	١ـ ناوەند، ناوەندی ٢ـ ڕاگەیێن، میدیا
memory	بیرگە
menu	لیسته، پێڕست
message	پەیام
messenger	پەیامبەر، نامەبەر، تەتەر
method	شێواز، ڕێگا
minicomputer	گچكەبژمێر، کۆمپیوتەری گچکەلە
mirror	ئاوێنە
mobile	جووڵاو، بزۆک، گەڕۆک
mobile-phone-	تەلەفۆنی گەڕۆک، تەلەفۆنی دەستی، تەلەفۆنی بزۆک
mode	دۆخ، بار، شێواز
model	مۆدێل، نموونە
modem	مۆدێم
N+-	"ئێن+"
Name-Server	ڕاژەكاری ناو
namespace	بۆشاییناو
nand	"ناند"، "نە و"، "نه + و"
nano	"نانۆ"
nanotechnology	تەكنەلۆژیای نانۆ
narrowband	كورتەباند، تەسكەباند
NASA	ناسا، فەرمانگەی نەتەوایەتیی هەواگەردی و بۆشایی (لە ئەمریکادا)
NAT	ئێن‌ئەی‌تی
native	ڕەسەن، خۆماڵی، خۆیی، خۆوڵاتی، ناوخۆیی، بنەچەیی
native-language	زمانی بنەچەیی
natural	سرووشتی
navigate	ڕێنیشاندان، ڕێدۆزی
navigation	ڕێنیشاندەری، ڕێدۆزی
navigator	ڕێنیشاندەر، ڕیدۆز
NDIS	ئێن‌دی‌ئای‌ئێس
NDS	ئێن‌دی‌ئێس
negative-(-)	نەرێنی
nest	هێلانە
net	تۆڕ
net-surfer	وێبگەردی تۆڕ
NetBEUI	(NetBEUI)
NetBIOS	(NetBIOS)، "نێت‌بایووس"، سیستەمی کارپێکردنی تێچووـ دەرچووی بنەڕەتیی ڕایەڵە
netware-(1)	ڕایەڵەواڵە
NetWare-(2)	(NetWare)، "نێتوێر"
Network	ڕایەڵه، تۆڕ
network-card	كارتی ڕایەڵە
Network-File-System-	(NFS)، "ئێن‌ئێف‌ئێس" سیستەمی پەڕگەی ڕایەڵە
Network-Information-Center-	(NIC)، "نیک"، ناوەندی زانیاریی ڕایەڵە
Network-Information-Service-	ڕاژەی زانیاریی ‌ڕایەڵه، "نیس"
Network-News-Transfer-Protocol-	(NNTP)، ئێن‌ئێن‌تی‌پی، کۆنووسی گواستنەوەی هەواڵ لە ڕایەڵە
network-user-indentifer-	پێناسەری بەکارهێنەری ڕایەڵە، نهێنیی ناسینەوەی بەکارهێنەری ڕایەڵە
newbie	دەستپێكەر
Newsgroup	گرووپەهەواڵ
next	داهاتوو، دوایی، ئەوی تر
nibble	٤ بیت، نیو بایت
NIC	كارتی ڕایەڵە یان Network Information Center
nil	سفر، چۆڵ، واڵا
nill-(=-null)	چۆڵ، خاڵی، بۆش، واڵا، بەتاڵ
node	گرێ
NOR	(NOR)، توخمی ئێن‌ئۆئار
normalization	ئاساییكردنەوە
note	١ـ تێبینی، سەرنج ٢ـ یاداشت ٣ـ پەراوێز
notebook-computer	پێژمێری پەڕتووكی
Novell	(Novell)، نۆڤێل
NSA	(NSA)، ڕێکخراوەی نهێنیناسیی فەرمیی ئەمریکا
NTFS	(NTFS)، ئێن‌تی‌ئێف‌ئێس
null-(1)	١ـ بێبار، نێرەمووک ٢ـ چۆڵ ٣ـ سفر ٤ـ بێبایەخ، بێنرخ
null-(2)-(=-empty)	چۆڵ، پووچ، خاڵی، واڵا، ڤالا
null-character-	نووسەی پووچ
num-lock-key	قوفڵەكلیلی ژمارەكان، كلیلی قوفڵی ژمارەكان
number	ژمارە
numeric-	ژمارەیی
NDIS	ئێن‌دی‌ئای‌ئێس
NDS	ئێن‌دی‌ئێس
negative-(-)	نەرێنی
nest	هێلانە
net	تۆڕ
net-surfer	وێبگەردی تۆڕ
NetBEUI	(NetBEUI)
NetBIOS	(NetBIOS)، "نێت‌بایووس"، سیستەمی کارپێکردنی تێچووـ دەرچووی بنەڕەتیی ڕایەڵە
netware-(1)	ڕایەڵەواڵە
NetWare-(2)	(NetWare)، "نێتوێر"
Network	ڕایەڵه، تۆڕ
network-card	كارتی ڕایەڵە
Network-File-System-	(NFS)، "ئێن‌ئێف‌ئێس" سیستەمی پەڕگەی ڕایەڵە
Network-Information-Center-	(NIC)، "نیک"، ناوەندی زانیاریی ڕایەڵە
Network-Information-Service-	ڕاژەی زانیاریی ‌ڕایەڵه، "نیس"
object	تەن
object-linking-and-embedding-	بەستەرلێدان و خستنەناوکاری تەنەکان، "ئوو‌ئێڵ‌ئی OLE"، تەنە پێكەوە پێچراوەكان
object-oriented-	تەنخواز
object-oriented-analyse	شیتەڵكاریی تەنخواز
object-oriented-design	داڕشتنی تەنخواز
object-oriented-programming	بەرنامەسازیی تەنخواز
octal	سیستەمی ژمارەییی هەشتی
office-(1)	نووسینگە
Office-(2)-(=-Microsoft-Office)	(Office)، ئافیس، ئۆفیس، مایکرۆسۆفت ئۆفیس
offline	دەرهێڵ
online	سەرهێڵ
open	كراوە
Open-Software-Foundation	دەستەی نەرمەواڵە كراوە
Open-system	سیستەمی كراوه، سیستەم‌کراوە
opensource	سەرچاوەكراوە، ژێدەركراوه ‌
operand	کردەژمارە، کردەوەند
operate	١ـ کردەگەریکردن، کردەکردن ٢ـ وەگەڕخستن، خستنەگەڕ، ئیشپێکردن ٣ـ نەشتەرگەریکردن
operating	١ـ کارپێکردن، کارا ٢ـ کردەگەری
Operating-System	سیستەمی کارپێکردن، سیستەمی کارا، سیستەم‌کارا
operation	کردار، کار، کرده، کردەگەری‌
operator-(1)	ئوپەراتۆر، کردەگەر، کرێکار، کرێکاری کۆمپیوتەر، جێبەجێکەری کاروباری کۆمپیوتەر
operator-(2)	كردەهێما
optic	١ـ ڕووناکی (هی ڕووناکی) ٢ـ چاوی، بینایی
optical	١ـ بینایی ٢ـ ڕووناکی، ڕووناکیناسی، ئۆپتیکی
option	هەڵبژاردن
OR	"ئۆر"، "یا"
Oracle	(Oracle)، "ئووراکل"
organize	ڕێکخستن
original-equipment-manufacturer	دروستکەری کەرەستەی ڕەسەن، ئوو‌ئی‌ئێم
outbox	ناردنگه، ناردنگەی نامە
output-(1)	دەرخستە، دەرچوو، دەرخراو
output-(2)-(device)	دەرخستە، دەرچوو، ئامێری دەرچوو، بەدەربەر، ئامێری بەدەربەر
output-(3)	١ـ دەرۆچکە ٢ـ دەرچوونگە ٣ـ بەرهەم ٤ـ دەرەنجام
overview	پوختە، کورتە، هەڵسەنگاندنێکی گشتی
overview-diagram	پێنوێنی پوختە، پێنوێنی گشتی
owner	خاوەن
open	كراوە
Open-Software-Foundation	دەستەی نەرمەواڵە كراوە
Open-system	سیستەمی كراوه، سیستەم‌کراوە
opensource	سەرچاوەكراوە، ژێدەركراوه ‌
operand	کردەژمارە، کردەوەند
operate	١ـ کردەگەریکردن، کردەکردن ٢ـ وەگەڕخستن، خستنەگەڕ، ئیشپێکردن ٣ـ نەشتەرگەریکردن
operating	١ـ کارپێکردن، کارا ٢ـ کردەگەری
Operating-System	سیستەمی کارپێکردن، سیستەمی کارا، سیستەم‌کارا
operation	کردار، کار، کرده، کردەگەری‌
operator-(1)	ئوپەراتۆر، کردەگەر، کرێکار، کرێکاری کۆمپیوتەر، جێبەجێکەری کاروباری کۆمپیوتەر
operator-(2)	كردەهێما
optic	١ـ ڕووناکی (هی ڕووناکی) ٢ـ چاوی، بینایی
optical	١ـ بینایی ٢ـ ڕووناکی، ڕووناکیناسی، ئۆپتیکی
pack	گورزە، بەستەک، پریاسکە
packet-(1)	پاکەت، بەستەکی بیتی، پریاسکەی بیتی، گورزەبیتی
packet-(2)	پریاسکۆکە، پریاسکەی بچکۆلە
page	‌ پەڕه
paging	پەڕەكردن، پەڕاوین.
paint	دیمەنکێشان، وێنەکێشان، نیگارکێشان ڕەنگکاریکردن
paint-box	ڕەنگدان
pakage	گورزە
paragraph	بڕگە، پاراگراف، پەرەگراف
parameter-(1)	ڕاگەیێن، دیاریكەر، پارامەتر
parameter-(2)	١ـ ژمارەی نرخی گۆڕاو ٢ـ سنوور، ڕادە ٣ـ نیشانە، تایبەخۆ
part	بەش، پارچە ٢ـ بەشکردن، جیاکردنەوە ٣ـ بەشبوون، جیابوونەوە
partition	پارچە
passive	١ـ ناچالاك، ناڕاستەوخۆ ٢ـ بەرهەڵستینەکەر
password	تێپەڕوشە، تێپەڕەوشه، وشەی تێپەڕبوون
paste	لكاندن
patch	پینە
path	١ـ ڕێچکە، باریکەڕێ، توولەڕێ، لاڕێ، گوزەر، پیادەڕێ ٢ـ ڕێڕەو ـ پشكنڕێ
pathfinder	پێشڕەو، ڕێی تازەدۆزەرەوە
patience	١- ئارامگرتن، خۆگرتن، سرەوت، تاقەت، دان بەخۆداگرتن، دەرکردن ٢- یارییەکی کاغەزیی یەککەسییە
pause	گت، وەستان
PC-(1)	پی‌سی، کۆمپیوتەری کەسی، کۆمپیوتەری خۆیی، پێژمێری کەسی، پێژمێری خۆیی
PC-(2)	پی‌سی، کۆمپیوتەری کەسی
PC-(3)	پی‌سی، ئای‌بی‌ئێم‌پی‌سی
PCI	(PCI)، پی‌سی‌ئای
PCI-bus-speed	خێراییی تێپەڕگەی پی‌سی‌ئای
percentage	ڕێژەی سەدی
peripheral	ئامێری دەرەكی، لائامێر، ئامێری تەنیشتی، تەنیشتەئامێر
permit	ڕێدان
person	کەس
Personal-&-Computer	کۆمپیوتە‌ر (پێژمێری) کەسی
Personal-Computer-(PC)	کۆمپیوتە‌ر (پێژمێر)ی کەسی
phishing-	تۆڕەماسی
ping	(ping)، پینگ
pixel	وێنەخاڵ
plan-(1)	١ـ نەخشه، گەڵاڵە ٢ـ ڕەنگڕشتن ٣ ـ نەخشەی کار، بەرنامەی کار، بەرنامە، پلان‌ ٤ـ نەخشەکێشان، ڕەنگڕشتن ٥ـ نەخشەدانان، پلاندانان، بەرنامەدانان
PLAN-(2)	"پلان" (ناوی زمانێکی بەرنامەسازی)
platform	سەکۆ
platform-independence	سەربەخۆیی لە سەکۆ
play	لێدان
plot-(1)	١ـ وێنە، نەخشە، نیگار، بیچم ٢ـ وێنەکێشان، نەخشکێشان، نیگارکێشان
plot-(2)	تەرز، بیچم، داڕشتنی گشتی
Plotter	کێشەر، نەخشکێشەر، وێنەکێشەر، نیگارکێشەر، بیچمکێشەر، پلۆتەر
plug-and-play-(1)	پێوەكردن و لێدان
Plug-and-Play-(2)	(Plug and Play)، پلاگ‌ئەند‌پلەی
plug-in	پێوەكردن، پێوەکراو
PnP-(1)	بنواڕەplug-and-play
PNP-(2)	"پی‌ئێن‌پی"
point	بۆر، خاڵ
Point-to-Point-Protocol-	پرۆتۆکۆلی‌ خاڵ-بە-خاڵ، پرۆتۆکۆلی خاڵ‌بە‌خاڵ
pointer	نیشاندەر
policy	ڕێباز
pop-(1)	(pop)، "پاپ، پۆپ"، دەرپەڕاندن، لابردن
pop-(2)	دەرپەڕاندن، جێبەجێکردنی کردەی "پۆپ"
POP-(3)	pop، لابردن
pop-up	پۆپئەپ، سەرهەڵدەر (لەپڕ سەرهەڵدەر)
pop-up-menu	منووی سەرهەڵدەر
popular	١ـ گشتی ٢ـ بەبرەو، بەباو، باو، ویستراو
port-(1)	دەرگا
port-(2)	دەرگا
port-(3)	دەرگا
port-(4)	ڕاگواستن
port-(5)	دەرگا، دەرگە، دەرکە
port-(6)	زارک، دەم
portability	هەڵگرتەنێتی، توانای گواستنەوە یان هەڵگیران بۆهەبوون
portable	هەلگرتەنی، هەڵگرتنی، هەڵدەگیرێ، دەستی
portable-computer	پێژمێری هەڵگرتەنی، کۆمپیوتەری هەڵگرتەنی
positive-(+)	ئەرێنی
power	هێز، وزه
power-supply	سەرچاوەخۆراک، سەرچاوەخۆراکی ئەلەکترۆنیکی، سەرچاوەبژیو
preference	هەڵبژاردە
prefix	١- پێشگر ٢- پێشبەند، پێشکۆ
presentation	پێشكەشكاری
preview	پێشبینین
primary	سەرەتایی
prime-number	ژمارەی خۆبەش
print	چاپ، دەرنووس، دەرنووسكردن
Print-Screen-key	دوگمەی چاپكردنی پەردە
printer	چاپكەر، چاپگەر، دەرنووسگەر
priority	پێشەنگی
privacy	١ـ تایبەتێتی، سەربەخۆیی ٢ـ نهێنێتی
private	خۆیی، کەسی، تاکەکەسی، تایبەتی، ناگشتی، تایبەت بە خۆ
process	١ـ پرۆسه ٢ـ چارەسەر ٣ـ ڕێکخەر
processing-	١ـ چارەسەری ٢ـ ڕێکخەری
processor	١ـ چارەسەركەر ٢ـ ڕێکخەر
product	بەرهەم
professional	١ـ "پیشەیی، پیشەگەرییانە". ٢ـ "پیشەگەر، پیشەوەر".٣ـ "کارناس، پسپۆڕ، لێزان".
profile	١ـ زانیاریی تایبەتی ٢ـ لاڕوو
program	١ـ پرۆگرام، بەرنامە ٢ـ پرۆگرامکردن (لە پێژمێردا) ٣ـ بەرنامەدانان ٤ـ بەرنامەی ڕادیۆیی، بەرنامەی تەلەفزیۆنی
programmer	بەرنامەساز، بەرنامەچێکەر، بەرنامەدانەر، بەرنامەسازی کۆمپیوتەر، بەرنامەداڕێژ
programming	بەرنامەسازی، بەرنامەچێکەری، چێکردنی بەرنامەی کۆمپیوتەر
progress	پێشكەوتن، بەردەوامبوون، ڕەوت، چوونەپێش
projector	وێنەنوێن، پرۆجەكتۆر
property	تایبەتمەندی
protect	پاراستن
protocol	کۆنووس، پرۆتۆكۆڵ
provider	دابینكار، دابینكەر
proxy-(server)	(proxy)، پراکسی، پرۆکسی، پێشكار
publish	بڵاوكردنەوە
pull	ڕاکێشان
pull-down	داڕماندن، داخزاندن ـ داخزاو
pull-down-menu	لیستەی داخزاو
punch_card	كارتی كونكراو
punctuation	١ـ خاڵبەندیکردن، خاڵ‌وبۆر بۆدانان ٢ـ خاڵبەندی، خاڵ‌و‌بۆر
push	١ـ پەستاوتن، دەستپیانان ٢ـ (دەست)داگرتن، (دەست)خستنەسەر
Python	پایسن، زمانێكی بەرنامەداڕشتنە
paste	لكاندن
patch	پینە
path	١ـ ڕێچکە، باریکەڕێ، توولەڕێ، لاڕێ، گوزەر، پیادەڕێ ٢ـ ڕێڕەو ـ پشكنڕێ
pathfinder	پێشڕەو، ڕێی تازەدۆزەرەوە
patience	١- ئارامگرتن، خۆگرتن، سرەوت، تاقەت، دان بەخۆداگرتن، دەرکردن ٢- یارییەکی کاغەزیی یەککەسییە
pause	گت، وەستان
PC-(1)	پی‌سی، کۆمپیوتەری کەسی، کۆمپیوتەری خۆیی، پێژمێری کەسی، پێژمێری خۆیی
PC-(2)	پی‌سی، کۆمپیوتەری کەسی
PC-(3)	پی‌سی، ئای‌بی‌ئێم‌پی‌سی
PCI	(PCI)، پی‌سی‌ئای
PCI-bus-speed	خێراییی تێپەڕگەی پی‌سی‌ئای
percentage	ڕێژەی سەدی
peripheral	ئامێری دەرەكی، لائامێر، ئامێری تەنیشتی، تەنیشتەئامێر
permit	ڕێدان
person	کەس
QT-(1)	(QT)، "كیوتی"
QT-(4)	"کیوت"
quad	چوارجا
quality	١ـ جۆرایەتی ٢ـ تایبەخۆ ٣ـ نایاب، زۆر باش، باش ٤ـ چۆنێتی
Quality-of-Service	جۆرایەتیی ڕاژە
Quarter-Inch-Cartridge-	پاشەكەوتكەری دراوەی موگناتیسی
Qubit-	هاوشێوەی پێوانەی دووانییە
query-	پرس، داوا، داواكاری
Questions-and-Answers-	لیستەی پرسیار و وەڵامەکان، (
queue	ڕیز
quick	خێرا
Quick-Time-	"كویك تایم"
quit	وازهێنان، چوونەدەرەوە
quit-talking-	چوونەدەرەوە لە چات یان وتووێژی دەق
quiz	١ـ تاقیلە، تاقیکاریلە، تاقیکاری (تاقیکارییەکی ناسەرەکی) ٢ـ پێشبڕکێ (ناو. بۆ وێنە ڕادیۆ و تەلەفزیۆن)
quota	بەش
quote	دەق
qwerty	(qwerty) "كوێرتی"
qwertz	(qwertz)، "كوێرتز"
quick	خێرا
Quick-Time-	"كویك تایم"
quit	وازهێنان، چوونەدەرەوە
quit-talking-	چوونەدەرەوە لە چات یان وتووێژی دەق
quiz	١ـ تاقیلە، تاقیکاریلە، تاقیکاری (تاقیکارییەکی ناسەرەکی) ٢ـ پێشبڕکێ (ناو. بۆ وێنە ڕادیۆ و تەلەفزیۆن)
quota	بەش
quote	دەق
qwerty	(qwerty) "كوێرتی"
qwertz	(qwertz)، "كوێرتز"
radio	١ـ ڕادیۆ، ئامێری ڕادیۆ ٢ـ ڕادیۆیی، تیشک ٣ـ بێتەلناردن، ناردنی ڕادیۆیی
radio-button	کلیلی ڕادیۆیی
RAID	(RAID)، ڕەید، ڕیزەکی زێدەداری دیسکە هەرزانباییەکان
RAM-	"ڕەم"، "ڕام"، بیرگەی دەستپێگەیشتن-‌بەهەڵکەوت، بیرگەی دەستپێگەیشتنی ڕاستەوخۆ
RAR	ڕاڕ
RAR-file	پەڕگەی ڕاڕ
RAS-(1)	(RAS)، "ڕاس"، "ڕەس"، ڕاژەکانی دوورەدەستپێگەیشتن، ڕاژەکانی دەستپێگەیشتن لەڕێی دوورەوە
ratio	ڕێژە
raw	خاو
real-time	كاتی ڕاستی
reboot	"بووت"كردنەوە، سەرلەنوێ خستنەڕێ
recent	تازە (ڕوودان)، نوێ
recently	تازە، لەم دوایییەدا
record	تۆماركردن
recovery	گەڕاندنەوە
redo	كردنەوه
redundant	زێدە، ناپێویست
refresh	نوێكردنەوه، تازەكردنەوە، بووژاندنەوە
register	تۆمار
registration	تۆماركردن
registry	تۆمارگە
regret	١ـ پەشیمانی، پاشگەزی ٢ـ پەشیمانبوونەوە، پاشگەزبوونەوە
reject	بەرپەرچدانەوە، پەسەندنەكردن
relation	پەیوەندی
release	١ـ بەرەڵاکردن، بەردان، ئازادکردن ٢ـ بڵاوکردنەوە (فیلم، پەڕتووک، دەنگوباس ... هتد) ٣ـ شتی بڵاوکراوە (فیلم، پەڕتووک، دەنگوباس ... هتد) ٤ـ دەرچوونی وەشانێکی نوێ لە نەرمەواڵەیەک
reload	باركردنەوە
remote-	دوور، ڕێی دوور
remote-control	کۆنترۆڵ لە دوورەوە، دوورکۆنترۆڵ، دوورەکۆنترۆڵ
remove	لابردن
rename-(1)	ناونانەوە، دیسان ناونانەوە
RENAME-(2)	"ڕینەیم"
rendering	پوختەكردن
renew	نوێكردنەوە
repeat	١ـ دووپات ٢ـ دووپاتکردنەوە ٣ـ دووپاتبوونەوە
repeater	بەهێزكەر، دووبارەكەرەوە
replace-(1)	١ـ خستنەشوێنی خۆی ٢ـ جێگرتنەوە، شوێنگرتنەوە ٣ـ لەجێدانان ٤ـ جێگۆڕین، خستنەبریکردن، گۆڕینەوە
REPLACE-(2)	"ڕیپلەیس"
replication	دووپات، ڕوونووس
request	داوا
require	پێویستبوون
resell	فرۆشتنەوە
reseller	فرۆشەرەوە، دووبارە فرۆشەر
reset	ڕێكخستنەوە
response	وەڵام
restart	دەستپێكردنەوە
restore	گەڕاندنەوە
resume	بەردەوامبوونەوە، تێچوونەوە، خستنەوەكار، بەدەستهێنانەوە
roll-in	ناو-خلۆر
roll-out	دەر-خلۆر
rollback	گەڕاندنەوە
rollover	بەسەرداجووڵان
ROM	(ROM)، "ڕام"، بیرگەی تەنیا-خوێندنی
root	ڕەگ
rotate	خولاندنەوە، كرداری سووڕدان
rotation	سووڕ، خول
rotation-per-minute-	سووڕ لە خولەکدا
router	"ڕۆوتە"، "ڕۆوتەر"، ڕێدۆز
row	١ـ ڕز، ڕیز ٢ـ دێڕ ٣ـ ڕزکردن، ڕیزکردن
row-address-strobe	تیشکی ناونیشانی دێڕ
ruler	ڕاستە
run	١ـ جێبەجێ ٢ـ جێبەجێکردن، بەڕێوەبەردن (لە کۆمپیوتەردا، پێدانی پەڕگە بە وەرگێڕ، یان جێبەجێی پەڕگەی exe و لەو چەشنە) ٣ـ گەڕان، كاركردن، ئیشكردن (بۆ وێنە لە مەکینەدا)
runtime-(=-run-time)	ماوەی گەڕان، ماوەی جێبەجێکردن، كاتی جێبەجێكردن
recovery	گەڕاندنەوە
redo	كردنەوه
redundant	زێدە، ناپێویست
refresh	نوێكردنەوه، تازەكردنەوە، بووژاندنەوە
register	تۆمار
registration	تۆماركردن
registry	تۆمارگە
regret	١ـ پەشیمانی، پاشگەزی ٢ـ پەشیمانبوونەوە، پاشگەزبوونەوە
reject	بەرپەرچدانەوە، پەسەندنەكردن
relation	پەیوەندی
release	١ـ بەرەڵاکردن، بەردان، ئازادکردن ٢ـ بڵاوکردنەوە (فیلم، پەڕتووک، دەنگوباس ... هتد) ٣ـ شتی بڵاوکراوە (فیلم، پەڕتووک، دەنگوباس ... هتد) ٤ـ دەرچوونی وەشانێکی نوێ لە نەرمەواڵەیەک
reload	باركردنەوە
remote-	دوور، ڕێی دوور
remote-control	کۆنترۆڵ لە دوورەوە، دوورکۆنترۆڵ، دوورەکۆنترۆڵ
remove	لابردن
save	پاشەكەوت
save-as	پاشەكەوت وەك
scan	پشکنین، پێداگەڕی
scanner	پشکنەر، پێداگەڕ، وێنەخوێن، وێنەخوێنەر، "سکانێر"
scanning	پشکنین، پێداگەڕان
scanning-device	ئامێری پشکنین، ئامێری پێداگەڕان
scene	دیمەن
schema	گەڵاڵە، نەخشە، وێنەی پیشاندەر
scheme	گەڵاڵە، پلان، نەخشە، ڕێدانان ٢- نەخشەکێشان، ڕێدانان
scope	بوار
screen	پەردە
screensaver	پەردەپارێز
script	نووسراو، سکریپت، دەستنووس، نووسینە
script-editor	دەستکاریکەری نووسینە
script-file	پەڕگەی نووسینە
scriptwriter	نووسەر
scroll	١ـ کێشان ٢ـ پێچۆکە ٣ـ پێچۆکەنواندن، پێچۆکەنوێنی ٤ـ پێچۆکەگەری
scroll-arrow	تیرەپێچۆکە
scroll-bar	تووڵەكێشان، تووڵەپێچۆکە، تووڵەپێچۆکەدان
scroll-buffer	نێوانگری پێچۆکە
scroll-down	داکێشان، پێچۆکەداکێشان
scroll-left	١ـ چەپڕۆییی پێچۆکە (جووڵانی ئاسۆییی پەردەپیشان بەشێوەی پێچۆکەیەک بۆ لای چەپ) ٢ـ بۆ لای چەپ ڕۆیشتنی پێچۆکە ٣ـ بۆ لای چەپ بردنی پێچۆکە)
scroll-right	١ـ ڕاستڕۆییی پێچۆکە (جووڵانی ئاسۆییی پەردەپیشان بەشێوەی پێچۆکەیەک بۆ لای ڕاست) ٢ـ بۆ لای ڕاست ڕۆیشتنی پێچۆکە ٣ـ بۆ لای ڕاست بردنی پێچۆکە
scroll-up	هەڵکێشان، پێچۆکەهەڵکێشان
scrollning	پێچۆکەگەری، بەپێچۆکەپیشاندان
scrub	خاوێنگەرییی بیرگە
SCSI	(SCSI)، "سکازی"
search	گەڕان، پشکنین
search-engine	مەکینەی پشکنەر، ماتۆڕی پشکنەر، نەرمەواڵەی پشکنەر
searcher	پشکنەر، گەڕانکار، بگەڕ
section	بەش، کەرت
security	پاراستن
seed	تۆو، تۆوكردن، چاندن
selection	دیاریكردن
selsyn	"سێلسین"
send	ناردن
sensor	هەستەوەر
sequence	ڕیزه، زنجیره
serial	زنجیرەبەست، زنجیرەیی
series	زنجیرە
server	ڕاژەكار
service	ڕاژه
session-(1)	خولێکی کاری، دانیشتن، کۆڕ
session-(2)	کۆڕی وانە، وانەکۆڕ، پۆل
setting	ڕێکخستن
settings	ڕێکخستنەکان
setup	جێگیركردن
shape	شێوە، شێواز
share-(1)	١ـ بەش، پشک، بەرکەوت ٢ـ بەشکردن، دابەشکردن ٣ـ هاوبەشیکردن، بەشکردن لەگەڵدا
SHARE-(2)	"شەیر"
shareware	هاوبەشەواڵە، دابەشەواڵە
shareware/freeware	هاوبەشەواڵە/ خۆڕاییواڵە
sheet	پەڕە
shell-(1)	چوونەدەرەوە بۆ سیستەم، "شێڵ"
shell-(2)	١ـ توێکڵ ٢ـ قاوغ
shell-script	نووسینە (سکریپت)ی "شێڵ"
shift-(1)	١ـ شوێنگۆڕین، گواستنەوە ٢ـ شوێنگواستنەوە، شوێنگۆڕان
shift-(2)	گۆڕەر
SHIFT-(3)	"شیفت"
shift-(4)	نۆرەی کاری، نۆرەکار‌، شیفت
short	كورت
shortcut	قەدبڕ
sign-in	واژۆكردن
signature	واژۆ
site	شوێن، جێ، پێگە، بنکە
skin	پێست
slash	لارەهیڵ
slice	پارچه،‌ قاژ، كەرت
slide	سلاید
slide-layout	گەڵاڵەبەندیی سلاید
slot	قڵیش
socket	پێكەوەبەست
software	نەر‌مەواڵە، نەرمەئامێر‌، كاڵانەرم
software-platform	سەکۆی نەرمەواڵە، سەکۆی نەرمەکاڵا
sound-card	كارتی دەنگ
source	سەرچاوە
space	بۆشایی
spacebar	نێوانتووڵ
spam	پۆستی نەخوازراو
spoof(ed)-web-site	وێبگەی ساخته
spool	نۆرە
spyware	سیخوڕیواڵە، پرۆگرامی سیخوڕی
SQL	(SQL)، "سیكوێڵ"
SSH	ئێس‌ئێس‌ئێچ
standalone	سەربەخۆ
standard	ئاسایی، پێوانە، نموونەیی، ستاندارد
start	دەستپێكردن، دەستپێك
startpage	دەستپێك ـ لاپەڕەی دەستپێك
stationary	جێگیر
statistics	سەرژمێری
status	ئاست، دۆخ
storage-(1)	بیرگە
storage-(2)	بیرگەی یاریدە
storage-(3)	بیرگەی سەرەکی
storage-(4)	پاشەکەوت، پاشەکەوتگەری
store	كۆگا، كۆگاكردن
storekeeping	كۆگا
story-board	پێگەی كاركردن
stream	تەوژم
string	ڕیزبەند، زنجیرەنووسە
strobe	تیشک، تیسک، ترووسک، ڕووناکی، پرشنگ
structure	پێكهاتە
style	شێواز
sub-	"ژێر-"
subnet-(=-subnetwork)	(subnet)، ژێرڕایەڵە
subnet-mask	(subnet mask)، پۆششی ژێرڕایەڵە
subscribe	بەشداربوون
support	پاڵپشتکردن، پاڵپشتیکردن، پشتیوانی
surfing	وێبگەردی، وێبگەڕی
switch	کلیل، سویچ
symbol	نیشانە ، هێما
SYN-(1)	سین، پارچەی هاوکاتگەر
SYN-(2)	سین، نووسەی هاوکاتگەر
SYN-(3)	سین، بەتاڵیی هاوکاتگەر
SYN-character-	بنواڕە synchronous idle character
sync	هاوکاتگەری
sync-bit	بیتی هاوکاتگەری
synchro-(1)	هاوکاتگەر، هاودەمگەر، "سەنکرۆ"
synchro-(2)	"هاوکات ـ"
synchronise-	بنواڕە synchronize
synchronism	هاوکاتی، هاودەمی، هاوهەنگاوی
synchronization-(1)	هاوکاتی، هاودەمی
synchronization-(2)	هاوکاتگەری، هاوکاتسازی
synchronization-bit	بیتی هاوکاتگەری
synchronization-character-	نووسەی هاوکاتگەری
synchronization-field	بواری هاوکاتگەری
synchronization-pattern	شێوەئاسای هاوکاتگەری
synchronization-pulse-	پرتەی هاوکاتگەری
synchronize	هاوکاتکردن، هاودەمکردن، هاوهەنگاوکردن
synchronized	هاوکات، هاودەم
synchronizer	هاوکاتگەر
synchronizing	١ـ هاوکاتگەری (ناو) ٢ـ هاوکاتگەر، هاوکاتساز (ئاوەڵناو)
synchronizing-character-	بنواڕە SYN
synchronizing-signal	نیشانەی هاوکاتگەر
synchronous	هاوکات، هاودەم
synchronous-idle-character-	نووسەی بەتاڵی هاوکاتگەری، نووسەی بێکاروئیشیی هاوکات
syntax	ڕستەكار، داڕستن
system	سیستەم
scriptwriter	نووسەر
scroll	١ـ کێشان ٢ـ پێچۆکە ٣ـ پێچۆکەنواندن، پێچۆکەنوێنی ٤ـ پێچۆکەگەری
scroll-arrow	تیرەپێچۆکە
scroll-bar	تووڵەكێشان، تووڵەپێچۆکە، تووڵەپێچۆکەدان
scroll-buffer	نێوانگری پێچۆکە
scroll-down	داکێشان، پێچۆکەداکێشان
scroll-left	١ـ چەپڕۆییی پێچۆکە (جووڵانی ئاسۆییی پەردەپیشان بەشێوەی پێچۆکەیەک بۆ لای چەپ) ٢ـ بۆ لای چەپ ڕۆیشتنی پێچۆکە ٣ـ بۆ لای چەپ بردنی پێچۆکە)
scroll-right	١ـ ڕاستڕۆییی پێچۆکە (جووڵانی ئاسۆییی پەردەپیشان بەشێوەی پێچۆکەیەک بۆ لای ڕاست) ٢ـ بۆ لای ڕاست ڕۆیشتنی پێچۆکە ٣ـ بۆ لای ڕاست بردنی پێچۆکە
scroll-up	هەڵکێشان، پێچۆکەهەڵکێشان
scrollning	پێچۆکەگەری، بەپێچۆکەپیشاندان
scrub	خاوێنگەرییی بیرگە
SCSI	(SCSI)، "سکازی"
search	گەڕان، پشکنین
search-engine	مەکینەی پشکنەر، ماتۆڕی پشکنەر، نەرمەواڵەی پشکنەر
searcher	پشکنەر، گەڕانکار، بگەڕ
tab-(1)	سەرخشتە، "تاب"
tab-(2)	بازدان، بازپێدان، پەڕاندن، خشتاندن، جووڵەکردن لە خشتەدا
tab-(3)	١ـ کلیلی خشتەبەندی ٢ـ لێدانی کلیلی خشتەبەندی
tab-(4)	زمانە، گوێچکەکارت
Tab-key	بازدەر، دوگمەی تاب
tabbing	١ـ خشتەبەندی ٢ـ لێدانی کلیلی خشتەبەندی، بازدان، بازپێدان
table	خشتە
tag	تاگ
tape	شریت، نەوار - تۆماركردن لەسەر شریت (نەوار)
target	مەبەست، ئامانج
task	كار، ئەرك
TCP-	تی‌سی‌پی، پرۆتۆكۆلی کۆنترۆڵی ناردن، کۆنووسی کۆنترۆڵی ناردن
TCP/IP	(TCP/IP)، تی‌سی‌پی‌/ ئای‌پی، پرۆتۆکۆڵی کۆنترۆڵی ناردن/ ‌‌پرۆتۆکۆڵی ئینتەرنێت
TCP/IP-Protocol-Family	بنەماڵەی پرۆتۆکۆڵەکانی تی‌سی‌پی/‌ ئای‌پی
technology	تەكنۆلۆژیا، تێکنۆڵۆجی، تەكنیكزانی، پیشەزانی
tele-education	دوورەفێركاری
telework-	دووركاری
telework-center	بنكەی دووركاری، ناوەندی دوورکاری
telex-	تێلێکس، تەلەفۆنی دەقی، دەقەتەلەفۆن
Telnet	(Telnet)، تێل‌نێت
template	داڕێژە
temporary	كاتی
terminal	تێرمیناڵ، کۆتاگە
terminate	كۆتاییپێهێنان
text	دەق
text-processing	دەقڕێکخەری، دەقکاری
text-processor	دەقڕێکخەر، دەقکار
Text-String	دەقەڕیزبەند
texture	چنین، ڕستن
TFT	(TFT)، تی‌ئێف‌تی
theme	١ـ باس، سەرباس، بابەت ٢ـ وتار ٣ـ ئاواز
Time-to-live-	کاتی ژیان، کات‌-بۆ-ژیان
timeline	كاتهێڵ
tips	ڕێنیشاندان، ڕوونكردنەوە
title	سەردێڕ
toggle	toggle، زامن
tool	ئامراز
toolbar	تووڵامراز، میلامراز
top	لووتكە، سەرتۆپ
topic	بابەت
topology	تۆپۆلۆژی، شێوەناسی
touch	ساو، ساوان، دەستلێدان
touch-mobile	ساوموبایل
touch-screen	ساوپەردە
track-(1)	١ـ شەقار (لە دیسکدا)، لێوارە‌ (لە شیریتدا) ٢ـ شوێنپێ ٣ـ شوێنکەوتن، سۆراخکردن
track-(2)	"ترەک"، "تراک"
track-address	ناونیشانی شەقار
trackback	ڕێباز، ڕێچكە
trackball-(=-track-ball)	گۆسووڕ
transaction	ڕێككەوتن، گواستنەوە
transfer	گواستنەوە
transform	گۆڕین
transmission	ناردن
transparent	ڕوون، ڕۆشن، پاشبین
trick	فێڵ، تەڵە
tridimensional-	سێلایی
Trojan-horse	ئەسپی ترووجان
TTL-(2)	(TTL)، تی‌تی‌ئێڵ
type	١ـ جۆر ٢ـ چاپكردن
tele-education	دوورەفێركاری
telework-	دووركاری
telework-center	بنكەی دووركاری، ناوەندی دوورکاری
telex-	تێلێکس، تەلەفۆنی دەقی، دەقەتەلەفۆن
Telnet	(Telnet)، تێل‌نێت
template	داڕێژە
temporary	كاتی
terminal	تێرمیناڵ، کۆتاگە
terminate	كۆتاییپێهێنان
text	دەق
text-processing	دەقڕێکخەری، دەقکاری
text-processor	دەقڕێکخەر، دەقکار
Text-String	دەقەڕیزبەند
texture	چنین، ڕستن
TFT	(TFT)، تی‌ئێف‌تی
Ubuntu	ئوبونتوو
UCP-(1)	"یووسی‌پی"، کۆنووسی گشتیی کۆمپیوتەر، کۆنووسی جیهانیی کۆمپیوتەر
UCP-(2)	"یووسی‌پی‌"، کۆنووسی لەبەرگرتنەوەی یونیکس-بۆ یونیکس
UDA	"یوودی‌ئەی"، دەستپێگەیشتنی دراوەی جیهانی
UDF	"یوودی‌ئێف"، فۆرماتی جیهانیی دیسک
UDMA	(UDMA)، "یوودی‌ئێم‌ئەی"
UDO	"یوودی‌ئەو"، ڕووناکیی لەژوورچڕی
UDP	"یوودی‌پی"، کۆنووسی داتاگرامی بەکارهێنەر
UHF	"یووئێچ‌ئێف"، لەرەی لەژووربەرز
UI	"یووئای"، ناوبەستی بەکارهێنەر، نێوانەڕووی بەکارهێنەر
UIML	"یووئای‌ئێم‌ئێڵ"، زمانی هێمادانانی ناوبەستی بەکارهێنەر
ultra-	لەولا، لەژوور، لەوپەڕ
UML-(1)	(UML)، "یووئێم‌ئێڵ" زمانی یەکگرتووی مۆدێلدانان
UML-(2)	(UML)، "یووئێم‌ئێڵ"
UMS	(UMS)، "یووئێم‌ئێس"
UMTS	(UMTS)، "یووئێم‌تی‌ئێس"، سیستەمی پێوەندیی بێتەلی گەڕۆکی جیهانی
unary	یەكانی
UNC	پەیمانی ناونانی جیهانی
underscore	بنهێڵ
undo	پووچکردنەوە، هەڵوەشاندنەوە، سڕینەوە
undo-buffer	نێوانگری پووچکردنەوە
undo-disk	پەپکەی پووچکردنەوە، دیسکی پووچکردنەوە
Unicast	یونیكەست
Unicode	یونیكۆد
Unified-Modeling-Language-	زمانی یەكگرتووی مۆدێلدانان
uninstall	دامەزرانسڕی، دامەزرانسڕینەوە، هەڵوەشاندنەوە
union	یەکێتی
unique	بێهاوتا، بێوێنە
unit	یەكە
Universal-Naming-Convention-	پەیمانی ناونانی جیهانی
UNIX	یونیكس
unmute	نەکپاندن، کپنەکردن، دەنگبەردان
unsigned	بێنیشانه، بێهێما
up-time-(=-uptime)	کاتی کردنەوە، کاتی چالاکی
update	نوێكردنەوە، ئەمڕۆژیكردن، بەڕۆژکردن
upgrade	بەرزكردنەوە
uplink	باركردن، سەرخستن
upload	باركردن
UPnP	(UPnP)، پێوەکردن و لێدانی جیهانی
UPS	(UPS)، سەرچاوە ئازووقەی بێپچڕان
upstream	سەرخستن، ڕەوتی بەرەوبان، ڕەوتی بەرەوسەر، ڕەوتی بەرەوژوور، ڕەوتبان، ڕەوتسەر
URI-	(URI)، "یووئارئای"، ناسێنەری سەرچاوەی چوونیەک‌
URL	(URL)، ئرڵ، یووئارئێڵ، شوێندۆزی سەرچاوەی جیهانی
USB	(USB)، یوو‌ئێس‌بی، تێپەڕگەی زنجیرەبەستی گشتی
User	بەكارهێنەر
user-ID	پێناسەی بەكارهێنەر، ناسنامەی بەكارهێنەر
user-name	ناوی بەكارهێنەر
user-friendly	بەكارهێنەرپەسەن
USSD	(USSD)، "یووئێس‌ئێس‌دی"، ڕاژە دراوەی پاشکۆییی ناڕێکپێکهاتوو
utility	بەكەڵك، سوودمەند، سوودمەندی
UTP	(UTP)، "یووتی‌پی"، جووتەکێبڵی بادراوی بێپۆشەر
UMTS	(UMTS)، "یووئێم‌تی‌ئێس"، سیستەمی پێوەندیی بێتەلی گەڕۆکی جیهانی
unary	یەكانی
UNC	پەیمانی ناونانی جیهانی
underscore	بنهێڵ
undo	پووچکردنەوە، هەڵوەشاندنەوە، سڕینەوە
undo-buffer	نێوانگری پووچکردنەوە
undo-disk	پەپکەی پووچکردنەوە، دیسکی پووچکردنەوە
Unicast	یونیكەست
Unicode	یونیكۆد
Unified-Modeling-Language-	زمانی یەكگرتووی مۆدێلدانان
uninstall	دامەزرانسڕی، دامەزرانسڕینەوە، هەڵوەشاندنەوە
union	یەکێتی
unique	بێهاوتا، بێوێنە
unit	یەكە
Universal-Naming-Convention-	پەیمانی ناونانی جیهانی
value	نرخ
variable	گۆڕاو
VBS	بنواڕە Visual Basic Script
VCD	(VCD)، دیسکی پەستاوتەی ڤیدیۆ
vector	ئاراستەبڕ
vendor	فرۆشیار
verbose	درێژە
verify	١ـ سەلماندن، بەڵگەبۆهێنانەوە ٢ـ ساغکردنەوە (ڕاستیی شتێک)
version	وەشان
video	١ـ ڕەنگی، وێنەیی، ڤیدیۆ ٢ـ ڕەنگ، وێنە، ڤیدیۆ
view	بینین، پیشاندان
virtual	گریمانە، گریمانەکی
virtual-private-network-	گریمانە ڕایەڵەی خۆیی، ڕایەڵەی خۆییی گریمانەکی
virus	ڤایرۆس
visual	بینراو، دیدەیی، دیدەنی، دیداری
Visual-Basic-	ڤیژواڵ بەیسیك، بەیسیکی دیدەیی
Visual-Basic-Script-	ڤیژواڵ بەیسیك سكریپت، سکریپتی بەیسیکی دیدەیی
VLAN	(VLAN)، "ڤی‌لان"
voice	دەنگ
Voice-Card	کارتی دەنگ
VOIP	گواستنەوەی دەنگ لە ڕێگەی (IP)ەوه
volume	پلەی دەنگ، قەبارە، بەرگ
vulnerable	بەرگەنەگر
virus	ڤایرۆس
visual	بینراو، دیدەیی، دیدەنی، دیداری
Visual-Basic-	ڤیژواڵ بەیسیك، بەیسیکی دیدەیی
Visual-Basic-Script-	ڤیژواڵ بەیسیك سكریپت، سکریپتی بەیسیکی دیدەیی
VLAN	(VLAN)، "ڤی‌لان"
voice	دەنگ
Voice-Card	کارتی دەنگ
VOIP	گواستنەوەی دەنگ لە ڕێگەی (IP)ەوه
volume	پلەی دەنگ، قەبارە، بەرگ
vulnerable	بەرگەنەگر
WAN-	(WAN)، ڕایەڵەی ڕووبەربڵاو
wap-(1)	(wap)، "واپ"، پرۆتۆکۆلی بەکاربەریی بێتەل
wap-(2)	(wap)، "واپ"، خاڵی دەستپێگەیشتنی بێتەل
ware	واڵە، ئامێر، کاڵا
Warez	(warez)، "وەیرز"، "وارێز"
watchdog	پارێزەر، پاسەوان، سەگی پاسەوان
watchdog-timer-	کاتپێوی پاسەوان
wav	(wav, wave)، "واڤ، وەیڤ"
wave-(1)	شەپۆل
web	وێب
web-browser	وێبگەڕ
web-page	وێبپەڕ
webcam	وێبكام
Webcast	پەخشی وێب
Webcasting	وێبپەخشی
WebDAV	(WebDAV)، "وێب‌داڤ"
weblog	وێبلۆگ
webmaster	وێبداڕێژ، وێبکار، وێبگەر، بەرپرسی وێب
webserver	ڕاژەكاری وێب، وێبڕاژەكار
website	وێبگە
whois	(whois)، "هووئیز"
wideband	پانەباند
widget	"ویجیت"
window	پەنجەرە، دەلاقە
window-driven-interface	ناوبەستی پەنجەرەئاژۆ، ناوبەستی وێنۆچکەئاژۆ
Windows	"ویندۆز"، ویندۆز مایکرۆسۆفت، "ئێم‌ئێس‌ویندۆز"
WINS	(WINS)، "وینس"، "وینز"، ڕاژەی ناونانی ئینتەرنێتی ویندۆز
Winsock-	(Winsock)، "وین‌سوک"
wireless	بێسیم، بێتەل
wizard-(1)	فێرکار، ئامۆژگار، بلیمەت، شارەزا، "مامۆستا"، جادووگەر، "ویزارد"
wizard-(2)	"ویزارد"، مامۆستا
WLAN	(WLAN)، "لان"ی بێتەل
Word	پرۆگرامی وۆرد
word-processing	وشەڕێکخەری
word-processor	وشەڕێکخەر
workstation	وێستگەی كار
World-Wide-Web-	(www)، "ووو"، "وێب"، وێبی جیهان‌بەرین، جیهانی وێب
writable	شیاوی خوێندن، خوێندەنی
WYSBYGI	(WYSBYGI)، "ویزبی‌گی"
WYSIWYG-	(wysiwyg)، "ویزی‌ویگ"
Webcasting	وێبپەخشی
WebDAV	(WebDAV)، "وێب‌داڤ"
weblog	وێبلۆگ
webmaster	وێبداڕێژ، وێبکار، وێبگەر، بەرپرسی وێب
webserver	ڕاژەكاری وێب، وێبڕاژەكار
website	وێبگە
whois	(whois)، "هووئیز"
wideband	پانەباند
widget	"ویجیت"
window	پەنجەرە، دەلاقە
window-driven-interface	ناوبەستی پەنجەرەئاژۆ، ناوبەستی وێنۆچکەئاژۆ
Windows	"ویندۆز"، ویندۆز مایکرۆسۆفت، "ئێم‌ئێس‌ویندۆز"
WINS	(WINS)، "وینس"، "وینز"، ڕاژەی ناونانی ئینتەرنێتی ویندۆز
Winsock-	(Winsock)، "وین‌سوک"
wireless	بێسیم، بێتەل
X.21	ئیکس-٢١
X.25-	ئیکس-٢٥
X.400-	ئیکس-٤٠٠
X.500	ئیکس-٥٠٠
X.75	ئیکس‌-٧٥
x86	(x86)، ئیکس٨٦
xclient	(xclient)
XDSL	(XDSL)، "ئێکس‌دی‌ئێس‌ئێڵ"
Xenix	سیستەمی كارپێكردنی "كسێنیكس"
XHTML	(XHTML)، "ئێکس‌ئێچ‌تی‌ئێم‌ئێڵ" زمانی هێمادانانی سەروودەقی پەرەسەندنێتی
XML	(XML)، "ئێکس‌ئێم‌ئێڵ"، زمانی هێمادانانی پەرەسەندنێتی
Xmodem	"ئێکس-مۆدێم"
XOR	(XOR)، "ئێکس-ئۆر"
XPath	(XPath)
XQuery	(XQuery)
xserver	(xserver)
XSL	(XSL)، "ئێکس‌ئێس‌ئێڵ"، زمانی شێوازەپەڕەی پەرەسەندنێتی
xserver	(xserver)
XSL	(XSL)، "ئێکس‌ئێس‌ئێڵ"، زمانی شێوازەپەڕەی پەرەسەندنێتی
Y2K	"وای-توو-کەی"، "وای‌توو‌کەی" (ساڵی ٢٠٠٠)
YaST	(YaST)
Ymodem	(Ymodem)
ypserver	ypserver
yy	yy
z-axis	تەوەرەی "زد"
z-coordinate	تانوپۆی "زد"
Z80	زد-هەشتا
Z8000	زد-هەشت هەزار
zap	سڕینەوە
Zapf-Chancery	"زەپف چانسری"
zero	سفر
zero-condition-	دۆخی سفر
zero-element	توخمی سفر
zero-flag	نیشانەنوێنی سفر
zero-insertion-force-	تەوژمی دامەزراندنی سفر، "زیف"
zero-access-stroage	بیرگەی سفر-‌دەستپێگەیشتن
zero-address	بێناونیشان، سفرناونیشان
zero-addressed	سفرناونیشانی
zero-addressed-machine	مەکینەی سفرناونیشانی
zero-crossing	لە سفرپەڕینەوە
zero-insertion-force-	بێنیاز-لە-تەوژمی "زیف"
zero-level-classification	پۆل‌پۆلکردنی ئاستی سفر
zerodivide-	دابەشبوون بە سفر
zerofill-	پڕکردنەوە بە سفر
zeroization	سفراندن، سفرگەری، سفرسازی
zerolevel	ئاستی سفر، ئاستسفر
zetetics	زانستناسی، زانستزانی، زێتێتیک
ZIF-socket	پایەگری زیف، پایەگری پێویستنەبووی تەوژم
zine	"زین"، گۆڤاری ئەلەکترۆنی
zip	زیپ، پەستاندن
Zmodem	Zmodem
zone	ناوچە
zone-bit	بیتی ناوچە
ZOO	جۆرە درێژکراوەیەکی پەڕگە
zoom	زووم، وردبیندانان
zoom-in	زوومکردنی زێدەیی
zoom-out	زوومکردنی ڕۆچوونی
zoomable	زوومکردەنی
zooming	گەورەنوێنی، زوومگەری، وردبیندانان
Zope	Zope
ZV-Port	(ZV-Port)
zero-crossing	لە سفرپەڕینەوە
zero-insertion-force-	بێنیاز-لە-تەوژمی "زیف"
zero-level-classification	پۆل‌پۆلکردنی ئاستی سفر
zerodivide-	دابەشبوون بە سفر
zerofill-	پڕکردنەوە بە سفر
zeroization	سفراندن، سفرگەری، سفرسازی
zerolevel	ئاستی سفر، ئاستسفر
zetetics	زانستناسی، زانستزانی، زێتێتیک
ZIF-socket	پایەگری زیف، پایەگری پێویستنەبووی تەوژم
zine	"زین"، گۆڤاری ئەلەکترۆنی
zip	زیپ، پەستاندن
Zmodem	Zmodem
zone	ناوچە
zone-bit	بیتی ناوچە
ZOO	جۆرە درێژکراوەیەکی پەڕگە